Previously on "The Blacklist"...	سابقا في "القائمة السوداء"...
- You want to call your daddy?	-هل ترغبين في الإتصال بوالدك؟
- Yeah, I want to tell him I'm okay.	-نعم، أريد إخباره أنني بخير .
Okay.	حسنا.
Lizzy...	(ليزي)...
Be careful of your husband.	احذري من زوجك.
I can only lead you to the truth.	لا أستطيع سوى توجيهك نحو الحقيقة
I can't make you believe it.	لا أستطيع جعلك تصدقينها.
She's calling herself Jolene Parker.	إنها تسمي نفسها (جولين باركر).
Elizabeth Keen is not your wife, she's your target.	(إيليزابيث كين) ليست زوجتك، إنها هدف مهمتك.
You have been threatening to tell me the truth about my husband since the day we met, and I'm ready to listen.	لقد كنت تهدد بإخباري الحقيقة حول زوجي منذ اليوم الأول الذي التقينا فيه، وأنا مستعدة لسماعك.
Right now, the only thing that matters is the immediate threat...	حاليا، الشيء الوحيد المهم هو التهديد الحالي...
Your husband...	زوجك...
Finding out who he is and who he works for.	معرفة حقيقته ولصالح من يعمل.
The rest will come.	والبقية ستأتي.
I promise you.	أعدك بذلك.
	ما الذي حدث؟
	ما المشكلة؟ ابتعدوا عنها! -مالذي حدث؟
-	هيا
Asset on board. En route.	نحن في الطريق
12 cc epinephrine.	12سم مكعب من الادرينالين
Clear.	الآن
	هيا هيا
- 45 seconds.	بسرعة 45ثانية
-	ابتعد من فضلك -ما المشكلة؟ -توقف .
	انظر، ما هذا؟
-	ما الذي تبحث عنه؟ نعم اخرج
	افتح الباب
We need more adrenaline.	نحتاج المزيد من الأدرينالين.
Cover her mouth.	غط فمها
It's okay. It's okay. It's okay.	لا بأس، لا بأس، لا بأس.
Shh!	صه!
It's okay. You're okay. You're okay.	انت بخير، أنت بخير...
Rest. You'll be in America by morning.	ستكونين في أمريكا بحلول الصباح.
We're taking you to Washington, D.C.	سننقلك إلى العاصمة "واشنطن".
Do you know where the prisoner was transported to?	هل تعلم أين تم نقل السجين؟
Uh, Washington. Okay.	"واشنطن"، حسنا.
Yes, we'll take care of it.	نعم، سنهتم بالأمر.
Very good.	جيد للغاية.
-	"حزب الله" "سيتعين عليهم الإنتظار" "سنعود إلى واشنطن"
Washington?	"واشنظن"؟
Since when did Jolene Parker's case go from missing person to murder investigation?	منذ متى تحولت قضية (جولين باركر) من شخض مجهول إلى تحقيق في جريمة قتل؟
- And have you seen my keys?	-هل رأيت مفاتيحي؟
- It's crazy, right?	-إنه ضرب من الجنون، صحيح؟
Yeah, what, uh...	نعم، ماذا..
What happened?	ماذا حدث؟
The police say they have a person of interest.	تقول الشرطة أن لديهم شخصا ذو أهمية.
Really?	حقا؟
Who is it?	من يكون؟
What do they...	ماذا..
What do they know?	ماذا يعرفون؟
They're not sure.	إنهم ليسوا متأكدين.
Isn't it possible that she just left town like she said?	أليس من المحتمل أنها غادرت المدينة كما قالت؟
Moved to Dayton?	انتقلت إلى "دايتون"؟
They found blood...	لقد وجدوا دما..
Matches hers.	يطابق دمها.
You see this stuff every day...	أنت ترين هذه الأشياء يوميا...
You know, people getting hurt and killed... and...	كما تعلمين، أشخاص يتعرضون للأذى ويتعرضون للقتل.. بينما العكس بالنسبة لي.
I don't. It freaks me out.	إنه أمر يقلقني.
Just the thought of that happening to you, you know...	فقط التفكير بأن ذلك يحدث لك، تعلمين...
Just promise me you're as careful as you can be when you're at work.	عديني فقط أنك حذرة أثناء العمل.
- The desk.	-المكتب .
- Hmm?	-ماذا؟
By the computer...	امام الحاسوب...
That's where I saw your keys.	هنام رأيت مفاتيحك.
Oh. I'm gonna be so late.	سأتأخر.
I'm gonna give myself a tardy slip.	سأمنح نفسي زلة تأخر
Found 'em!	لقد وجدتهم
They were under the newspaper.	لقد كانوا أسفل الصحيفة.
What would I do without you?	ماذا سأفعل من دونك؟
I got to run.	علي الذهاب
Uh, tonight for dinner, let's check out that new thai place.	بالنسبة لعشاء الليلة، دعينا نتفقد ذلك المطعم التايلندي.
He knows something's off.	إنه يعلم أن هناك أمرا ما
What makes you say that?	ما الذي يجعلك تقولين ذلك؟
I can feel it. I know him.	يمكنني أن أشعر بذلك، أنا أعرفه.
Tom is on his heels. He's behaving erratically.	(توم) يشعر باليأس، إنه يتصرف بطريقة متقطعة.
He killed Jolene Parker.	لقد قتل (جولين باركر)
Yes.	نعم
You knew?	هل علمت بذلك؟
Why didn't you tell me?	لماذا لم تخبرني؟
I felt if I told you it would inform your behavior with him.	شعرت أنه لو أخبرتك سيعرف تصرفاتك اتجهاه.
I found her body, called the police, and reported a missing person.	لقد عثرت على الجثة، اتصلت بالشرطة، وبلغت عن شخص مفقود.
I was confident, in the course of their investigation, they would reach out to you and Tom, and they did.	كنت واثقا أنه في سياق تحقيقاتهم سيصلون إليك وإلى (توم)، وقد تمكنوا من ذلك.
Jolene Parker undoubtedly worked for the same organization as Tom...	(جولين باركر) عملت من دون شك لنفس المنظمة التي يعمل بها (توم)
In what capacity, I have no idea.	في أي مهمة، ليست لدي أدنى فكرة.
If they worked together, why would he murder her?	لو كانوا قد عملوا معا، لما عساه يقتلها؟
Perhaps he was ordered to.	ربما أُمر بذلك.
Or perhaps he's just...	أو ربما أنه...
Out of control, irrational...	خارح السيطرة، غير عقلاني..
Paranoid and reactionary.	مريض بالشك أو الرجعية.
He's scrambling for a foothold, and therein lies our opportunity to wait and to watch.	إنه يهرول نحو موطئ قدم وهنا تكمن فرصتنا في الإنتظار والمراقبة.
But Tom is not the reason I'm here.	لكن (توم) ليس سبب وجودي هنا.
I'm afraid there's something quite timely afoot.	أنا خائف أن هناك شيئا سيئا سيحدث
The Pavlovich brothers are back in town.	لقد عاد الإخوة "بافلوفيتش" إلى المدينة.
You're talking about the team from the bridge that grabbed the general's daughter.	أنت تتحدثين عن الفريق من الجسر الذين اختطفوا ابنة الحنرال.
They're an extraction team...	إنهم فريق الاختطاف بالقوة...
Cut their teeth on Milosevic's protective detail during the ethnic cleansing of the Yugoslav wars.	كانوا ضمن فريق الحماية الخاصة لـ(ميلوسيفيتش) إبان حروب التطهير العرقية في "يوغوزلافيا".
We lost six of our men that day.	لقد خسرنا ستة من أعضاء فريقنا يومها
To the best of our knowledge, the Pavlovich brothers have no political agenda.	على حد علمنا، ليس لدى الإخوة "بافلوفيتش" اجندة سياسية.
They specialize in snatch-and-grabs ranging from kidnap and ransom to extracting political dissidents.	هم مختصون في مجال الإستيلاء بين اختطاف وطلب فدية لإستخراح المعرضين السياسيين.
Reddington says he has a contact.	(ريدينغتون) يقول أن لديه اتصال.
A money launderer sourced by the brothers claims they're coming after a Chinese scientist named Xiaoping Li.	غاسل أموال من مصادر الإخوة يدعي أنهم قادمون سعيا وراء عالمة صينية تدعى (شاوبينغ لي).
- What do we know about her?	-ماذا لدينا بشأنها؟
- 18 hours ago, the agency sent an undercover team to extract her from a clandestine labor camp in the Yunnan province.	-منذ 18 ساعة، أرسلت الوكالة فريقا متخفيا لإستخراجها من معسكر عمل سري
- Break her out?	-لتهريبها؟ لمااذا؟
Why? - She's an immunologist...	-إنها متخصصة في علم المناعة ..
Specializes in viral and bacterial diseases.	تحديدا في الأمراض الفيروسية والبكتيرية.
Four months ago, she signaled to one of our assets that she had a willingness to talk about a secret weapons program.	قبل 4 أشهر، أشارت إلى أحد مساعدينا أن لديها استعدادا للحديث بخصوص برنامج سلاح سري.
A month later, she was jailed for treason.	بعد شهر، تم سجنها بتهمة الخيانة.
She's scheduled to land at Andrews in an under an hour, and we have a team standing by to escort her to Langley	من المقرر أن تهبط في مطار "آندروز" خلال أقل من ساعة، ولدينا فريق على أهبة الإستعداد لمرافقتها إلى "لانغلي"
- for a debriefing.	-لإستخلاص المعلموات .
- We got to assume that the Pavlovich brothers already know the route.	-علينا أن نفترض أن الإخوة "بافلوفيتش" يعرفون الطريق سلفا.
Well, then we'll reroute her. Bring her here.	حسنا، حينها سنعيد توجيهها وإحضارها إلى هنا.
Coordinate the adjustment with Langley.	نسقوا التعديل مع "لانغلي"
Echo to tango. Uh, asset at drop point.	من "إيكو" إلأى "تانغو" الهدف في المنطقة المحددة.
Roger. 30 seconds to rendezvous.	"روجر"، 30 ثانية على الموعد.
- This way. Quickly.	-من هنا، بسرعة .
- What's going on?	-ماذا يحدث؟
They said I'd be safe once I arrived.	قالوا أنني سأكون بأمان عندما أصل.
We have a credible threat you're being targeted.	لدينا تهديد موثوق أنت مستهدفة.
As a precaution, we've altered our route.	كإجراء وقائي، قمنا بتغيير طريقنا.
Get her up to the chopper.	اجعلها على متن المروحية.
Donald Ressler. FBI. Where's the asset?	(دونالد ريسلر)، المباحث الفدرالية أين هي؟
- Ground transport's been arranged.	-لقد تم ترتيب نقل أرضي .
- Negative.	-سلبي .
Evac's been compromised. Moving to beta proto...	تم اختراق "إيفاك"، انتقال إلى البرتوكول التجربيبي..
Call it in.	قم بالتبليغ
All right. Okay. Copy that.	حسنا، علم
Anne Arundel county sheriff's department's reporting a downed aircraft burning two miles outside of Crofton.	قائد شرطة مقاطعة "آن آروندل" بلغ عن سقوط واحتراق طائرة ميلين خارح "كروفن".
There's no witnesses on the ground.	لا يوجد هناك شهود عيان.
We do have units en route. It's got to be the dump site	لدينا وحدات في الطريق، يجب أن يكون موقع التفريغ
- on this chopper.	-لهذه المروحية .
- They knew CIA protocol...	-كانوا يعلمون بشأن بروتوكول وكالة الإستخبارات المركزية ..
That if the routes were compromised, they'd send in air support.	أنه لو كشفت الطرق، سيقومون بإرسال دعم جوي، هؤلاء الرجال لم ستندوا محليا.
These guys weren't based domestically. They snuck in, and they're gonna sneak out.	لقد تسللوا وهم داخلون، وسيتسللون وهم خارجين.
We should coordinate with homeland, get their faces everywhere.	يجب علينا التنسيق مع وزارة الأمن الداخلي، وزعوا صورهم في كل مكان.
Agent Malik, you want to tell me why the director of national intelligence is calling?	أيتها العميلة (ماليك)، هلاَّ أخبرتني لماذا يتصل مدير الإستخبارات؟
What don't I know about this case?	ماذا أجهل حول هذه القضية؟
The program li was working on...	البرنامج الذي كانت تعمل (لي) عليه...
It's germ weaponry...	هو سلاح جرثومي...
Banned by nearly every nation on Earth.	تم حظره من كل الدول على الأرض.
It's called Whitefog.	يسمى "الضباب الأبيض".
Day before she was jailed, Xiaoping Li sent a message indicating that she had access to the designs.	قبل أيام من اعتقالها أرسلت (لي) رسالة مشيرة من خلالها أنها تمكنت من الولوج للتصاميم.
If she did, and she shared those with us, that would represent the biggest intelligence coup in a decade.	لو فعلت وتشاركتها معنا، ذلك من شأنه أن يمثل أكبر انقلاب استخباراتي خلال عقد من الزمن.
A germ-warfare program?	برنامج حرب جرثومية؟
That's why the Chinese can't turn this into an international incident.	لهذا لا يمكن للصينيين قلب هذا إلى حادث دولي.
- Where are you?	-أنت أنت؟
- Busy.	-مشغولة .
The brothers...	الإخوة..
They took Xiaoping Li.	لقد أخدوا (شاوبينغ لي)
How do you know?	كيف تعرف؟
Do you have a lead?	هل لديك خيط؟
Something we can...	شيء يمكننا...
- Your husband is not in school.	-زوجك ليس في المدرسة .
- Wait. What?	مهلا، ماذا؟
Where is he?	أين هو؟
Meet me at 9th and Constitution.	قابليني عند شارع الدستور
Reddington says he has a lead on the brothers. Wants to talk.	(ريدينغتون) يقول أنه لديه دليل على مكان الإخوة، يريد التحدث.
Let me know what NTSB says about that downed aircraft.	أعلموني بما تقوله هية سلامة النقل بخصوص تلك الطائرة الساقطة.
Called in sick this morning.	بلغ أنه مريض هذا الصباح.
Returned home briefly before making a stop at the Radford Bank in Adams Morgan.	عاد للبيت لفترة وجيزة قبل أن يقوم بتوقف فعند"بنك راتفورد" في "آدامز مورغان".
He's made three phone calls...	لقد قام بثلاتة مكالمات هاتفية..
All from pay phones.	كلها من هاتف مدفوع.
He's been sitting at that cart for nearly an hour.	لقد كان يحلس في تلك العربة لمدة ساعة تقريبا.
I'm sorry, Lizzy.	أنا آسف (ليزي).
Don't be.	لا تكن كذلك.
This must be difficult.	لا بد وأن هذا صعب.
You want to know what's hard?	أترغب في معرفة ما هو الأصعب؟
Sitting here when all I really want to do is get my hands around his throat.	الحلوس هنا بينما كل ما أريد القيام به هو وضع يدي حول رقبته.
- Shouldn't we follow him?	-أليس علينا اللحاق به؟
- We are.	-نحن كذلك .
They all work for you.	جميعهم يعملون عندك
Lizzy, wait, wait, wait.	ليزي)، مهلا، مهلا، مهلا...
What are you do...	ماذا تريدين...
Not now.	ليس الآن.
The boat...	القارب..
How long for the boat?	كم يبعد القارب؟
No. No. Please, no.	لا، لا، من فضلك، لا.
Tom?	(توم)؟
Tom?	(توم)؟
I'm in the dining room.	أنا في غرفة الطعام
Where'd you get that thing?	من أين لك بذلك الشيء؟
I was gonna ask you the same question.	كنت سأسألك السؤال نفسه؟
I found it in the basement.	وجدته في القبو
That's where that was. I've been looking for it.	هناك حيث كان، لقد كنت أبحث عنه.
My father gave it to me.	والدي أعطاني إياه.
It's beautiful.	إنه رائع.
It's in great condition, too. It looks almost new.	إنه في حالة جيدة أيضا، يبدو جديدا كليا.
Why haven't I seen this before?	لم لم أر هذا الشيء من قبل؟
Your pot is gonna boil over.	وعاؤك الخاص سيغلى
You're cooking?	هل تطبخ؟
I thought we were going out for thai.	اعتقدت أننا سنذهب إلى ذلك المطعم التايلندي.
Yeah, well, I just thought it might be nice, you know, to stay home alone...	نعم، حسنا، اعتقد أنه ربما سيكون أمرا لطيفا، كما تعلمين، أن نبقى في البيت لوحدنا..
Just you and me.	أنت وأنت فقط.
How was your day?	كيف كان يومك؟
It was exhausting.	لقد كان مجهدا
You know Billy Salter?	أتعرفين (بيلي سالتر)؟
He was acting up again 'cause his mom keeps packing these fruit roll-ups, and they give him this satanic sugar high, you know.	كان يمثل مرة أخرى لأن والدته تواصل تعبئة تلك الفاكهة... يسببون له ارتفاعا رهيبا في السكر، لذا...
Oh, uh, I did stop by the national archives just to maybe book a field trip for the kids.	لقد توقفت عند الأرشيف الوطني ربما لحجز رحلة ميدانية للأطفال.
It's funny. I, uh...	إنه أمر مضحك...
I could have sworn that I saw you there.	يمكنني أن أقسم أنني رأيتك هناك
There was a woman there, and she looked just like you.	كانت هناك امرأة وكانت تبدو تماما مثلك.
Ah, no, I wish. I was cooped up in the office all day.	أتمنى ذلك، لكنني كنت محبوسة في المكتب طول اليوم.
Yeah.	نعم
Should have known.	كان يجب أن أعلم بذلك
Well, whoever she was, she could not have been half as beautiful as you are right now.	حسنا، مهمن تكن، لا يمكنها أن تكون بنصف جمالك الآن.
All right. Uh, keep stirring.	حسنا، واصلي التحريك
I'm gonna walk the dog.	سأقوم بإخراج الكلب.
Come on, bud. Hey, hey, hey.	هيا يا صديقي...
Come here.	هيا
Hey, hey, hey. Where you going?	إلى أين أنت ذاهب؟
Come here. Come here.	تعال هنا، تعال هنا.
Yes, you're a good boy.	نعم أنت كلب مطيع..
Yes, you are.	بالتأكيد أنت كذلك
Yes, you are.	أنت كذلك
What?	ماذا؟
Nothing.	لا شيء
Love you.	أحبك
- I'll be right back.	-سأعود في الحال..
Come on, bud. - Come on.	هيا يا صديقي
Come on.	هيا..
Such a good boy.	كلب مطيع
Bantam finance. How may I direct your call?	"بانتام" للتمويل، كيف يمكنني توجيه مكالمتك؟
Hi. I'm having a problem with my account.	مرحبا، لدي مشكلة مع حسابي
Uh, number Delta, Sierra, 4-5-1.	رقم: "ديلتا،سييرا، 4-5-1"
Line is secure. Proceed.	الخط آمن، أكمل
Mockingbird knows. Requesting immediate evac.	الطائر المحاكي يعلم، طلب الإخلاء حالا.
She knows.	إنها تعلم.
He's gone.	لقد ذهب.
My husband is gone.	لقد ذهب زوجي
Your husband never existed.	زوجك لم يكن له وجود من قبل.
Lizzy, I understand why you went after Tom today.	(ليزي)، أنا أفهم لم مشيت وراء (توم) اليوم
The instinct to jump in is...	تلك الغريزة هي..
But it isn't gonna serve you well here.	لكنها لن تخدم مصلحتك هنا.
And from the emotional point of view, this must feel like an extraordinary violation and betrayal.	ومن وجهة النظر العاطفية، لابد أن يكون هذا مثل انتهاك وخيانة غير عاديين.
But for Tom it was business.	لكن هذا بالنسبة لـ(توم) كان عملا.
Do you know we had sex the other night?	هل تعلم أننا مارسنا الجنس تلك الليلة؟
Do you have any idea how filthy that makes me feel?	هل لديك أدنى فكرة عن القذارة التي أشعر بها؟
Unfortunately, Lizzy, you're chest-deep in filth, and you're gonna have to wade through it	للأسف (ليزي)، أنت منغمسة في القذارة وعليك أن تبحري خلاله
- to get to the other side.	-للوصول للناحية الأخرى .
- I fell in love with him.	-لقد وقعت في حبه .
I married him.	لقد تزوجته.
We... we were gonna have...	نحن... كنا سنحظى...
I was excited to have a child with him.	لقد متحمسة لأن يكون لدي طفل برفقته.
He was the one person I chose in my life who made me happy, who made me feel safe.	لقد كان الشخص الوحيد الذي اخترته في حياتي والذي جعلني سعيدة، جعلني أحس بالأمان.
What does that say about me?	ماذا يخبر ذلك بشأني؟
Everything that we had was just a figment of my imagination...	كل ما كان لدينا كان فقط من نسج خيالي...
Worse than a figment...	أسوأ من خيال..
A lie.	كذبة.
It was right in front of my face, and I didn't see it.	كانت أمامي مباشرة، ولم أستطع رؤيتها.
I just... believed it.	لقد.. صدقتها فحسب.
All of it.	جميعها.
Time is the only thing that will allow you to find yourself again.	الوقت وحده الكفيل بأن يتيح لك إيجاد نفسك من جديد.
If you tell me to be patient one more time, I swear to God...	لو أخبرتني أن أصبر مرة أخرى أقسم بالله...
I am going to find him, I'm gonna find answers, and I'm going to do it with or without your help.	سأعثر عليه وأتبين الأجوبة وسأقوم بذلك سواء بمساعدتك أو بدونها.
The case.	لالقضية..
I need a lead.	أحتاج إلى دليل.
Lizzy, if you want to find where the Pavlovich brothers are, you need to find out where they've been.	(ليزي)، لز أردت معرفة مكانة الإخوة "بافلوفيتش"، عليك أن تكتشفي أين كانوا..
The helicopter is key.	المروحية هي مفتاح.
The Pavlovich brothers burnt that chopper to cover up evidence...	أحرق الإخوة "بافلوفيتش" تلك المروحية لتغطية أدلة..
DNA, fingerprints.	حمض نووي، بصمات أصابع.
Those things might have identified the brothers, but what about the chopper?	ربما تحدد تلك الأشياء الإخوة، لكن ماذا بشأن المروحية؟
The tail numbers were falsified, and the chopper was repainted.	لقد تم تزوير رقم الذيل، وتم إعادة طلاء المروحية.
That's what they did, but where did they do it?	هذا ما قاموا به، لكن أين قاموا بذلك؟
Is there a deeper forensic analysis we can run?	هل هناك تحليل أعمق للطب الشرعي يمكننا الخوض فيه؟
What particulates were in the heat exchange?	ما هي الجسيمات التي كانت في التبادل الحراري؟
Was there moisture in the compressor?	هل كانت هناك رطوبة في المحرك؟
I'll reach out to forensics.	سأصل للطب الشرعي
Analyze every drop of fuel. Track every grain of sand.	حللوا كل قطرة من الوقود، تتبعوا كل حبة رمل.
I want to know where that chopper's been.	أريد أن أعرف أين كانت تلك المروحية
That's him.	إنه هو.
I'm sorry, man. Not for hire.	آسف يا رجل، ليست للتأجير
Hello, Symir. I'll be brief and to the point.	مرحبا (سمير)، سأختصر حديثي وأمر مباشرة للموضوع.
Yesterday you had a customer...	بالأمس كان لديك زبون...
Picked him up outside the national archives.	نقلته خارج الأرشيف الوطني
Sorry, man.	آسف يا رجل
Ohh, Symir.	(سمير)...
You should have taken the money.	كان عليك أخد المال.
Your passenger...	راكبك..
Where'd you drop him?	إلى أين نقلته؟
Calculus.	الحساب...
I can't even think about derivatives without thinking of that tutor in manor hall...	لا أستطيع التفكير حتى في المشتقات بدون التفكير في ذلك المعلم في قاعة القصر...
Cindy something-or-other.	سيندي.. شيء أو آخر
Never wore a brassiere; Always a bounce in her step.	لم تكن ترتدي حمالة، هناك دائما ارتداد في خطاها.
Look, I'm talking, cooperating.	حسنا، أنا أتحدث وأتعاون
You don't need to copy my driver's license, my credit cards.	ليس عليك نسخ رخصة سياقتي بطائقي الإئتمانية
We just want to make sure we know where to reach you,	نريد فقط التأكد أننا نعلم أين يمكن أن نجدك
Geoffrey P. Seevers, should we have more questions.	(جوفري ب. سيفرز) هل يجب أن نسأل المزيد؟
So, tell me about the book.	حسنا، أخبرني بشأن الكتاب.
I told you...	لقد أخبرتك..
I pick up and drop off.	قمت بعملية النقل فقط
I don't know names. I'm the messenger.	أنا لا أعرف أية أسماء، أنا مجرد مرسول.
What is it?	ما هذا؟
Some kind of code?	شفرة من نوع ما؟
How many times have you done this... these drops?	كم مرة قمت بهذه العملية..
This was the fourth.	كانت هذه هي المرة الرابعة.
I need you to write down the location of each drop you've made...	أريد أن تقوم بتدوين موقع كل عملية نقل قمت بها...
The pickup and the drop location.	موقع الذي نقلت منه، والموقع الذي أوصلت إليه.
Oh, my God. What?	يا إلهي، ماذا؟
Pagosa Springs public library?	مكتبة "باغوسا سبرينغ" العامة؟
I had a water pump go out in Pagosa Springs.	كانت لدي مضخة مياه هناك
Bitch of a mountain... Wolf Creek Pass.	كلب جبال... "وولف كريك باس"
Thought I was gonna end up living out there with the hill people until this Teddy bear of a man fixed me up at the local garage.	اعتقدت انه سينتهي بي المطاف أعيش هناك رفقة قوم التل إلى أن قام هذا الرجل الذي يشبه الدبدوب بإدخالي إلى المرآب المحلي.
I'll never forget him. Tracy Woods.	لن أنساه أبدا، (تريسي وودز).
You don't know Tracy, do you?	أنت تعرف (تريسي)، أليس كذلك؟
Leather vest, mustache...	سترة جلدية، شارب...
Tracy Woods?	(تريسي وودز)؟
No.	لا.
I wonder if he's still fixing water pumps.	أتساءل هل ما زال يصلح مضخات المياه.
Anyway, it'll always be a fond memory.	على أي حال، ستكون دائما دكرى عزيزة.
The list.	القائمة.
S-so, that's it? We're...	إذن، هذا كل شيء، نحن...
What about the package?	ماذا بشأن الطرد؟
You're gonna deliver it or return it or whatever the people you work for want you to do with it.	ستقوم بتسليمه أو إرجاعه أو مهما من تعمل معهم يريدونك أن تفعل به.
And as far as you're concerned, we never had this conversation.	وعلى حد عملي، لم نحظى بهذه المحادثة.
Dembe?	(ديمبي)؟
A copy, please.	نسخة لو سمحت.
I hope you have nothing pressing.	آمل أنه ليس لديك شيء لطباعته
This may take a minute or three.	سيأخد هذا دقيقة أو ثلاتة
You sure you don't know him?	هل أنت متأكد أنك لا تعرفه؟
Leather vest, mustache...	سترة جلدية، شارب..
Tracy Woods?	(تريسي وودز)؟
Shame.	مؤسف
Hey.	مرحبا.
I got something.	لدي شيء ما.
Hey.	حسنا، لم أرغب في معرفة هذا القدر
Okay, I never wanted to know this much about gas chromatography or gear lubricants, but I think Mr. Reddington is onto something.	حول التفريق اللوني للغاز، أو معدات التشحيم، لكنني أعتقد أن السيد (ريدينغتون) يخطط لشيء ما.
Look at this.	القوا نظرة على هدا.
We pulled the lab reports from the NTSB, and the chopper's engine tested positive for two distinct compounds.	لقد قمنا بسحب تقرير مختبر هيئة سلامة النقل ومحرك المروحية أظهر نتائج إيجابية لفحص مركبين متميزين.
The first is ethephon, which is a ripening agent for tobacco.	الأول هو "إيثفون" وهو عامل نضوج التبغ
- And how does that help us?	-وكيف من شأن هذا أن يساعدنا؟
- Take a look.	-انظروا .
Tobacco production's way down in this area.	لقد انخفض إنتاج التبع في هذه المنظقة.
In fact, since 1998, the federal government is actually paying farmers not to grow it.	في الحقيقة، ومنذ سنة 1998، الحكومة الفدرالية تقوم بالدفع للمزارعين لعدم زراعتها.
Okay, but there's still plenty of tobacco farms.	حسنا، لكن ما يزال هناك العديد من مزارع التبغ.
I agree, which brings us to chemical compound number two.	أوافقك، ما يقودنا إلى المركب رقم اثنان.
This one is used to grow sweet corn.	هذا يستعمل لنمو الذُّرة الصفراء.
So we cross-reference the two?	إذن سنعتمد على كليهما؟
Exactly.	تماما، نحن نبحث عن صانع مبيد حشرات
We are looking for a pesticide manufacturer who used to supply tobacco growers but made the transition to corn.	الذي اعتاد تزويد مزارعي التبغ لكن انتقل إلى الذرة.
And how many of those are there?	وكم عددهم؟
17.	17.
Wait.	مهلا.
Of those, 11 are outside of the fuel range of this chopper.	هناك 11 منهم خارج مدى وقود هذه المروحية.
Uh, of the other six, uh, only one has a structure large enough to get that stolen helicopter out of view and under construction.	الستة الآخرون، واحدة فقط لديه بنية كبيرة بما يكفي لجعل تلك المروجية
Halifax Agro-Chem.	"مختبر هالفيكس للزراعة الكيميائية"
If I had to bet, I'd say that's their staging site.	لو كنت سأراهن، سأقول أن ذلك هو موقعهم.
It's around the corner, half a block up.	إنه قريب، على بعد نصف بناية
I make seven exterior cameras, and those are the ones they want us to see.	وضعت 7 كاميرات مراقبة خارحية، وتلك هي التي يرغبون أن نراها.
And it's on the list of drop sites I gave you?	وهي على المواقع التي أعطيتك إياها؟
Yes.	نعم
How long has Mr. Keen been inside?	كم مضى على وجود السيد (كين) في الداخل؟
I tailed him here four hours ago.	تعقبته إلى هنا قبل أربع ساعات.
Lovely. Thank you, Preston.	جيد، شكرا لك (بريستون).
- You want me to call Sabusawa?	-تريدني أن أتصل بـ"سابوساوا"؟
- That would be ideal, but he's working an extraction in Ecuador.	-سيكون ذلك مثاليا . لكنه يعمل حاليا في "الإكوادور"
Then how do you plan on getting keen out of that concrete box?	كيف تخطط إذن لإبعاد (كين) عن ذلك الصندوق الخرساني؟
- We have a lead on Xiaoping Li.	-لدينا دليل على (شاوبينغ لي ).
- Excellent.	-ممتاز .
- Tell me.	-أخبريني .
- We think she's being held at Halifax Agro-Chem in Falls Church.	-نعتقد أنها محتجزة "داخل "مختبر هالفيكس للزراعة الكيميائية" في "فولز تشورش"
We're assembling a team.	نحن نقوم بجمع فريق.
Lizzy, about Tom...	(ليزي)، بخصوص (توم)...
I don't want to talk about Tom with you.	لا أريد أن أتحدث بشأن (توم) معك.
You have your opinion on how to proceed, and I have mine.	لديك طريقة لكيفية المتابعة، وأنا لدي طريقتي.
Just don't bother yourself. I'll deal with Tom.	لا تتعب نفسك فحسب سأتعامل مع (توم).
Lizzy, I assure you that will yield no answers and little satisfaction.	(ليزي)، أؤكد لك أن ذلك لن يعطيك إجابات أو أي إرضاء صغير.
Well, I'll find out, won't I?	حسنا، سأكتشف ذلك. أليس مذلك؟
I wish I could talk you out of this.	أتمنى لو يمكنني إقناعك بالعدول عن هذا.
You can't.	لا يمكنك ذلك.
Well, good luck with Xiaoping...	حسنا، حظا طيبا مع (شاوبينغ)..
Good afternoon, gentlemen.	مساء الخير أيها السادة.
I'm Raymond Reddington.	اسمي (رايموند ريدينغتون).
Hey. Look at this.	انظري إلى هذا
What are we looking at?	إلى ماذا ننظر؟
I have no idea.	ليست لدي فكرة.
Hey!	أنت!
Get out of here!	اخرح من هنا
Go!	اذهب!
	تم وضع الطرد، إلى مواقعكم العد إلى ثلاتة.
What the hell was that?	ماذا كان ذلك؟
Out! Out!	اخرحوا!
Move!	..
Move! Move!	هيا هيا!
Fall back. Asset en route. We're moving to the cars.	تراجع، نحن على الطريق، إننا ننتقل إلى السيارة.
-	سيارتان، (كين) في المقدمة
-	(كين) مازال طليقا
-	اصدمه إلى خارج الطريق
-	مرة أخرى
I mean, it looks like some sort of serial number.	أعني، إنه يبدو مثل رقم تسلسلي.
Or an atomic number...	أو رقم ذري...
Something from a periodic table.	شيء من جدول دوري.
Why do you think that?	لما تعتقدين ذلك؟
Because the only word I know that contains the letters "v-g" together is avgolemono.	لأن الكلمة الوحيدة التي أعرفها والتي تحتوي على حرفي "ف-غ" معا هي "آفغوليمونو".
I don't know what that is.	لا أعرف ماذا يكون
It's a soup.	إنه عبارة عن حساء
Chicken stock, egg yolks, and lemon juice.	مرق الدجاج، مح البيض وعصير البرتقال.
What?	ماذا؟
I cook.	أنا أطبخ.
The point is, maybe Xiaoping Li left us a message.	المغزى هو، ربما (شاوبينغ لي) تركت لنا رسالة.
I'll run the letter combination against the DMV registry	سأشغل مزيج الحروف في مكتب التسجيل
- and see if we can get a hit.	-ونرى ما يمكننا الحصول عليه .
- Any luck?	-هل حالفك الحظ؟
- I can't get ahold of Reddington.	-لا أستطيع الوصول إلى (ريدينغتون ).
- You told him the location where the brothers were holding Xiaoping Li, right?	-لقد اخبرته عن المكان حيث الذي يحتجز فيه الإخوة (شاوبينغ)، صحيح؟
- Mm-hmm.	ألا تجدين أن الأمر
- Don't you find it a hell of a coincidence that we show up there, they're gone, and now we can't get ahold of Reddington?	مصادفة غريبة أننا وصلنا هناك وهو اختفوا، والآن لا نستطيع الوصول لـ(ريدينغتون)؟
- We've been played.	-تم التلاعب بنا .
- No.	-لا .
Red put us on to the Pavlovich brothers because he knew it would lead him straight to Xiaoping Li.	أخبرنا (ريد) بشأن الإخوة "بافلوفيتش" لأنه علِم أن ذلك سيقوده مباشرة إلى (شاوبينغ لي).
That woman's worth millions.	تلك المرأة تساوي مليون.
Where are you going?	إلى أين تذهبين؟
I'm going to find Reddington, get some answers.	سأذهب للعثور على (ريدينغتون)، والحصول على بعض الأجوبة.
Reddington, I need you to call me, please.	(ريدينغتون)، أريدك أن تتصل بي، رجاءا.
I need some help with the case.	أحتاج لبعض المساعدة بخصوص القضية.
A gift from Reddington. Enjoy.	هدية من (ريدينغتون)، استمتعي بها.
Two years wasted.	أضعنا سنتين.
Two years we spent. On what?	أمضينا سنتين، على ماذا؟
Do you care at all what you've done to me...	هل تهتم مطلقا بما فعلته بي...
What you've done to my life?	ماذا فعلت بحياتي؟
What has it done to you?	بما أفادك ذلك؟
Who could do such a thing?	من قد يفعل شيئا كهذا؟
Finding you, stopping you...	إيجادك، إيقافك...
You'd think I'd be happy you're gonna spend the rest of your life in prison.	تعتقد أنني سأكون سعيدة بأنك ستمضي بقية حياتك في السجن.
You'd think I'd get some satisfaction out of that, but I don't because nothing...	هل تعتقد أنني سأحظى ببعض الرضى من خلال هذا، لكن لن أفعل ذلك لأن لا شيء...
No sentence, no punishment, no revenge, could ever come close to making up for what you've done.	لا عقوبة، لا عقاب، لا انتقام، أن يكون أقرب إلى التعويض عما قمت به.
- I was doing my job.	-كنت أقوم بعملي .
- Your job?	-عملك؟
That was our life!	تلك كانت حياتنا!
We were going to have a baby to...	لقد كنا على وشك أن نحظى بطفل...
You begged me to have a baby!	لقد ترجيتني ليكون لدينا طفل!
- I was doing my job.	-كنت أقوم بعملي .
- Stop talking about your job!	-توقف عن الحديث بشأن عملك !
You, this...	أنت، هذا..
Everything was a lie!	كل شيء كان كذبة!
My life was a lie!	حياتي كانت كذبة!
Every feeling, every memory...	كل شعور، كل ذكرى..
Say something to your wife, who's dying in front of you.	قل شيئا لزوجتك، التي تموت أمامك.
Say something.	قل شيئا.
It was the shoes.	لقد كانت الأحذية.
What does that mean?	ماذا يعني هذا؟
That's when I knew.	هناك حيث علمت.
It was those brown leather shoes.	لقد كانت تلك الأحذية الجلدية السمراء
It was our third or maybe fourth date.	كان ذلك ثالت أو رابع موعد لنا
You'd come over to my place on Halstead, and we ordered, uh...	أتيت إلى منزلي في "هالستيد"،
Takeout and rented a movie that we never finished because we ended up...	طلبنا أكلة جاهزة واستأجرنا فيلما والذي لم نكمله أبدا لأن المطاف انتهى بنا..
And you had to get up early for work.	وكان عليك الاستيقاظ باكرا لأجل العمل.
And by the time I got up, you were gone.	وفي الوقت الذي نهضت فيه، اختفيت
I remember standing in the closet, half-dressed, reaching for my shoes when I saw that you had drawn this little heart	أتذكر وقوفي في الحجرة، نصف عاري، أمد يدي إلى أحديثي حينما رأيت أنك رسمت ذلك القلب الصغير
In the dust on my shoe.	على غبار حذائي.
You remember that?	هل تذكرين ذلك؟
It was the sweetest thing.	كان ذلك أحلى شيء.
And ever since that moment, I just felt...	ومنذ تلك اللحظة، شعرت..
Sorry for you...	بالأسف عليك فحسب...
Because I knew...	لأنني عرفت..
I knew that I had you.	عرفت أنني تمكنت منك.
Part of me didn't want it to work...	جزء مني لم يرد لذلك الأمر أن ينجح...
But it did.	لكنه نجح.
Archimedes.	"أرخميدس".
Archimedes!	"أرخميدس"!
- I beg your pardon?	-معذرة؟
- Archimedes' formula.	-معادلة "أرخميدس "
You know, uh, the... the naked guy who shouted "Eureka."	تعلمون الرجل العاري الذي أطلف النار على "أوريكا"
Why would she write down a mathematical formula?	لماذا قد تدون معادلة رياضية؟
Maybe it's some kind of a code or a language they don't understand.	ربما هي عبارة عن شفرة من نوع ما أو لغة لا يفهمونها.
Archimedes' principle indicates that the upward buoyant force which is exerted on a body immersed in fluid,	يشير مبدأ "أرخميدس" إلى أن قوة الطفو التصاعدي الممارس على جسم مغمور في السائل،
- whether fully...	-سواء أكان كاملا ...
- Aram.	-آرام) ).
Um, water displacement. Boats displace water.	نزوح الماء، القوارب تزيح الماء.
She's trying to tell us how they're getting her out of the country.	إنها تحاول إخبارنا عن كيف سينقلونها خارج البلاد.
Contact the coast guard.	اتصلوا بخفر السواحل.
Get photos of the brothers and Xiaoping Li to every port authority on the eastern seaboard.	أرسلوا صورا للإخوة و(شاوبينغ لي) إلى كل إدارة ميناء داخل الساحل الشرقي.
What are you gonna tell him?	ماذا ستخبرينه؟
Hey. What's going on?	ما الذي يحدث؟
Where are we on Xiaoping Li?	أين وصلنا في قضية (شاوبينغ لي)؟
They're trying to ship her out of the country.	إنهم يحاولون إخراجها من البلاد بحرا.
We're combing through the manifests now. Where are you?	نحن نفتش من خلال قوائم الشحن الآن، أين أنت؟
Waiting on Reddington. He still hasn't shown.	في انتظار (ريدينغتون)، لم يظهر بعد.
I'm telling you, Keen. He used us.	كما أخبرتك (كين)، لقد استغلنا.
These guys...	هؤلاء الرجال..
The Pavlovich brothers...	الإخوة "بافلوفيتش"...
You remember what they did.	تذكرين ما قاموا به.
You were there that day on the bridge.	لقد كنت هناك ذلك اليوم على الجسر.
When we take them down, I want you to be there.	حينما نطيح بهم، أريدك أن تكوني هناك.
I will be, just as soon as...	سأكون هناك، تماما حينما...
I'm gonna have to call you back.	سأعيد الإتصال بك.
Nice try.	محاولة جيدة.
I was thirsty.	كنت أشعر بالعطش.
Yes?	نعم؟
- Where is she?	-أين هي؟
- Who?	-من؟
Xiaoping Li. You took her.	(شاوبينغ لي)، لقد أخدتها.
You used the FBI and the Pavlovich brothers to get to Tom and what, get Xiaoping?	لقد استغليت مكتب التحقيقات الفدرالي والإخوة "بافلوفيتش" للوصول إلى (توم) وماذا بعد. الحصول على (شاوبينغ)؟
Make some bigger deal?	القيام ببعض الصفقات الكبيرة؟
Trade on her secrets?	المتاجرة بأسرارها؟
I have no use for germ warfare.	ليست لي مصلحة في الحرب الجرثومية.
And as for using the FBI?	وبخصوص استغلال مكتب التحقيقات الفدرالي؟
I wouldn't be in this relationship if there wasn't a mutual benefit.	لم أكن لأكون طرفا في هذه العلاقة لو لم تكن هناك منافع مشتركة.
- Where is she?	-أين هي؟
- I don't know.	-لا أعلم .
I tried to bargain for her life, but negotiations went sideways.	حاولت المساومة على حياتها، لكن المفاوضات لم تسر في الإتجاه الصحيح.
It was all I could do to get Tom.	كان ذلك كل ما يمكنني القيام به للحصل على (توم).
If we don't find her...	لو لم نعثر عليها...
If she gets sent back to the Chinese,	لو تم إعادتها للصينيين،
- she's gonna die.	-سوف تموت .
- Tell me what you know.	-أخبريني بما تعلمين .
We think they're putting her on a cargo ship. We're not sure.	نعتقد أنهم يضعونها على متن سفينة شحن، لسنا متأكدين.
We're looking over the manifests, timetables,	نحن نفحص قوائم الشحن، جداول المواعيد،
- and shipping routes.	-وطرق الشحن .
- She isn't cargo, Lizzy.	-لم يتم شحنها يا (ليزي ).
She's contraband. This is a smuggling operation.	إنها مثل السلعة الممنوعة، هذه عملية تهريب.
And nothing gets smuggled in or out of the chesapeake without Rolph Cisco knowing about it.	ولا شيء يتم تهريبه داخل أو خارح "تشيزبيك" "{\cH1B92E5}تشيزبيك" خليج يقع في الأراضي الأمريكية دون أن يعلم (رولف سيسكو) بشأنه.
Have Donald pay him a visit.	اجعلي (دونالد) يزوره.
What is his obsession with you?	ما سبب هوسه بك؟
You guys got, like, a, uh, daddy-daughter thing going on?	أنتم تشبهون، شيء من قبيل أب-بنت يحدث؟
What's your plan?	ما هي خطتك؟
Is daddy coming over?	هل سيمر الاب بالجوار؟
Is he gonna make me talk?	هل سيجعلني أتكلم؟
No, he's not.	كلا.
I am.	أنا من سيفعل ذلك.
Rolph Cisco?	(رولف سيسكو)؟
Tell us about the Pavlovich brothers.	أخبرنا بشأن الإخوة "بافلوفيتش".
Who do you work for?	لصالح من تعمل؟
I have nothing to say.	ليس لدي شيء لأقوله.
- Who do you work for?	-لصالح من تعمل؟
- Liz, come on.	-ليز)، بحقك) .
You don't have it in you.	ليست من شيمك.
God! Aah!	يا إلهي!
Let me out of here! Please!	احرجوني من هنا، من فضلكم!
Get me out! Get me out!	أخرجوني، اخرجوني!
It's okay. It's okay.	لا بأس، لا بأس.
Easy, easy. We're the good guys.	على مهلك، على مهلك، نحن الأشخاص الأخيار.
Here. Come here.	هنا، تعالي هنا.
I'm gonna put you down.	سأضعط على الأرض.
Easy.	على مهلك
You broke my thumb.	لقد كسرت إبهامي.
Yeah, I did.	نعم، فعلت ذلك، لو كنت تبحث عن العطف،
If you're looking for sympathy, you might want to start with honesty.	ربما عليك البدء بالصدق.
Here's an example of honesty, Tom.	إليك مثالا عن الصدق يا (توم).
You've been making me pancakes for two years.	لقد كنت تُعِدُّ الفطائر من أجلي لمدة سنتين
- I hate pancakes.	-أكره الفطائر .
- You want honest?	-تريدين الصدق؟
Here's one.	إليك مثالا.
If you're gonna handcuff somebody, don't break their thumb.	لو كنت ستقيدين أحدهم، لا تكسري إبهامه.
Your handcuffs.	أصفادك.
One on the wrist. One on the banister. Do it.	واحد على الرسغ، والآخر على الدرج، نفذي ذلك.
I am not here to hurt you, Liz.	لست هنا لأقوم بإيذائك (ليز).
My job was never to hurt you.	لم تكن تلك مهمتي مطلقا.
I'm one of the good guys.	أنا أحد الأشخاص الطيبين.
Reddington...	(ريدينغتون)..
He's not who you think.	إنه ليس من تظنين.
- I will find you.	-سوف أعثر عليك .
- I can prove it.	-يمكنني إثبات ذلك .
The key in the lamp...	المفتاح في المصباح..
I know you found it.	أعلم أنك عثرت عليه.
Take it to radford bank. Box number 3929.	خديه إلى "بنك رادفورد"، صندوق رقم 3929.
He is not who you think he is.	إنه ليس من تعتقدين.
Goodbye, Liz.	وداعا (ليز).
You want me to stop him?	هل تريدني أن أوقفه؟
No, we'll just let the tail follow him.	لا، سندع الذيل يتبعه.
Tell me about Whitefog.	أخبريني عن "الضباب الأبيض"
Whitefog was a black project started	"الضباب الأبيض" مشروع أسود بدأ
By the Chinese government five years ago.	من طرف الحكومة الصينية قبل 5 سنوات
You want to tell me what's going on with Agent Keen?	هلا أخبرتني بما يحدث مع العميلة (كين)؟
- Sir?	-سيدي؟
- Where was she today?	-أين كانت هذا اليوم؟
And don't tell me you don't know.	ولا تخبرني أنك لا تعلم.
Was it Reddington?	هل الأمر متعلق بـ(ريدينغتون)؟
Are there problems?	هل هناك مشاكل؟
I think she's having troubles at home, sir.	أعتقد أنها تعاني من مشاكل في البيت يا سيدي.
I lost him.	لقد فقدته.
He's gone.	لقد اختفى.
No.	لا.
This whole time, you've never let him out of your sight.	كل هذا الوقت، لم تدعه يغيب عن ناظرك.
Your people are following him now.	رجالك يلاحقونه الآن.
They are.	بلى
How is this all gonna end?	كيف سينتهي كل هذا؟
This is an end.	هذه نهاية.
And then something new will begin.	حينها سيبدأ شيء جديد
You deserve the best in life, Lizzy.	أنت تستحقين أفضل ما في الحياة (ليزي).
I know that sounds odd coming from a man who has brought you some of the worst,	أعلم أن هذا يبدو غريبا أن يأتي من رجل جلب لك بعض أسوأ الأشياء،
but it's the reason why Tom had to work so hard to be that for you...	لكن هذا هو سبب عمل (توم) جاهدا ليكون هكذا بالنسبة لك...
To be kind, to be thoughtful, make you laugh, to make you love him.	ليكون رحيما، طيب القلب، يجعلك تضحكين، يحعلك تحبينه.
Because you deserve that.	لأنك تستحقين ذلك.
And it will come.	وسيأتي ذلك.
You don't get them girls loose loose	انت لا تحصل على بنات طليقات
(TJR!	(تي جي ار!
)	)
You don't get the world loose loose	انت لا تحصل على عالم طليق
You don't get money move move	انت لا تنفق مالك
But I do I do	لكن انا افعل
You don't get them girls loose loose	انت لا تحصل على بنات طليقات
You don't get the world loose loose	انت لا تحصل على عالم طليق
You don't get money move move	انت لا تنفق مالك
But I do I do	لكن انا افعل
I said, y'all having a good time out there	انا قلت, انتم جميعآ تقضون وقت جيد هناك
Yeah, yeah, que no pare la fiesta	نعم, نعم, انه العيد
Don't stop the party	لا توقف الحفلة
Yeah, yeah, que no pare la fiesta	نعم, نعم انه العيد
Don't stop the party	لا توقف الحفلة
I'm running through the world like I'm running back	اعبر العالم مثل ما اعود
Scarface, world's mine, running back 30, 000 people went here on me	سكارفايس, العالم ملكي, عدت مسرعآ 30000شخصنا هنا من اجلي
80, 000 in london wembley 90, 000 morocco, and I'm just getting warmed up, papo	80000في لندن 90000في المغرب, وانا فقط اصبح حامي, حبيبتي
Catch me with redone in stockholm, beirut, cafe getting my drink on, mole	امسكني مع روندون في إستوكهولم, بيروت, القهوى شرابي, مولي
We're how to put the women, here the hooka	نحن وضعنا النساء, هنا الجاذبية
All of them sweet, azucar, azucar Dale disfruta They can't, they won't, they never will, stop the party	كلهم جميلون هم لا يستطيعون, هم لا يريدون, هم لن يوقفون, اوقف الحفلة
They can't, they won't, they never will, stop the party	هم لا يستطيعون, هم لا يريدون, هم لن يوقفون, اوقف الحفلة
I said, y'all having a good time out there	انا قلت, انتم جميعآ تقضون وقت جيد هناك
Yeah, yeah, que no pare la fiesta	نعم, نعم, انه العيد
Don't stop the party	لا توقف الحفلة
Yeah, yeah, que no pare la fiesta	نعم, نعم, انه العيد
Don't stop the party	لا توقف الحفلة
I'm from the city, where they stress, and they sleep real bad	انا من مدينة, حين يشددون, ينامون بصورة سيئة
And now I'm doing shows in helsinki	والان اعمل في معارض هيلسكي
I know what ya'll thinking, you're thinking, that you can outhiking, but you can't frankly	اعلم بما تفكرون جميعآ, انتم تفكرون, بأنكم يمكن ان تخرجوه من تفكيركم, لكنكم لا تستطيعون بصراحة
I'm out for the benchies, frankies, chinos	انا خارج من اجل العاهرات, بصراحة, الصينيات
Just cause you ain't me, don't hate me	فقط بسبب انت لست انا, لا تكرهني
As a matter fact you should thank me	بالحقيقة انتة يجب ان تشكرني
Even if you don't, joel come yankees Zig-a zig-a zig-a zig-a Who got the key of the world, now, yours truly	حتى اذا انتة لا تفعل, سيأتون اليانكيين من الذي حصل على مفتاح العلم, الان انت المخلص
They can't, they won't, they never will, stop the party	هم لا يستطيعون, هم لا يريدون, هم لن يوقفون, اوقف الحفلة
They can't, they won't, they never will, stop the party	هم لا يستطيعون, هم لا يريدون, هم لن يوقفون, اوقف الحفلة
I said, y'all having a good time out there	انا قلت, انتم جميعآ تقضون وقت جيد هناك
Yeah, yeah, que no pare la fiesta	نعم, نعم, انه العيد
Don't stop the party	لا توقف الحفلة
Yeah, yeah, que no pare la fiesta	نعم, نعم, انه العيد
Don't stop the party	لا توفق الحفلة
I'mma give it to ya, ah ah	انا اعطيه اليك
Now give it to me, ah ah	الان اعطيه لي
I'mma give it to ya, ah ah	انا اعطيه اليك
Now give it to me, ah ah	الان اعطيه لي
I'mma give it to ya, ah ah	انا اعطيه اليك
Now give it to me, ah ah	الان اعطيه لي
Get funky, get funky	أٌصبح غير تقليدي, يُصبح غير تقليدي
Now stop!	! الان توقف
I said, y'all having a good time out there	انا قلت, انتم جميعآ تقضون وقت جيد هناك
Yeah, yeah, que no pare la fiesta	نعم, نعم انه العيد
Don't stop the party	لا توقف الحفلة
Yeah, yeah, que no pare la fiesta	نعم, نعم انه العيد
Don't stop the party	لا توقف الحفلة
Yeah, yeah, que no pare la fiesta	نعم, نعم, انه العيد
Don't stop the party	لا توقف الحفلة
Yeah, yeah, que no pare la fiesta	نعم,نعم, انه العيد
Don't stop the party	لا توقف الحفلة
Yeah, yeah, que no pare la fiesta	نعم,نعم, انه العيد
Don't stop the party	لا توقف الحفلة
Yeah, yeah, que no pare la fiesta	نعم,نعم, انه العيد
Don't stop the party	لا توقف الحفلة
For the first few nights of his new presidency,	‫في أول بضع ليالي ‫بعد منصبه الرئاسي الجديد
Theodore Roosevelt slept at the home of his sister, Bamie, at 1733 N street, while the widow of his murdered predecessor, William McKinley, packed up to leave Washington.	‫نام "ثيودور روزفلت" ‫في منزل أخته "بامي" في شارع "1733 إن". ‫بينما قامت أرملة سلفه المقتول "ويليام ‫ماكينلي" بحزم أمتعتها لمغادرة "واشنطن".
But every morning at 8:30, he started toward his office in the executive mansion 10 blocks away, while his secretary struggled to keep up.	‫ولكن كل صباح الساعة الثامنة والنصف ‫بدأ يمشي صوب مكتبه ‫في المبنى التنفيذي على بعد مسافة 10 جادات ‫بينما حاول مساعده اللحاق به بصعوبة.
His first night there was to be September 23, 1901, and since his wife and children had not yet arrived, he asked his sisters Bamie and Corinne and their husbands to join him for dinner.	‫كانت أول ليلة له هناك ‫في 23 سبتمبر 1901 ‫وبما أن زوجته وأولاده لم يصلوا بعد ‫طلب من أختيه "بامي" و"كورين" ‫وزوجيهما الانضمام إليه للعشاء.
The day before had been the birthday of the man whose memory meant the most to him...	‫في اليوم السابق، ‫كان عيد ميلاد شخص ذكراه
his father, Theodore Roosevelt, senior.	‫عنت أكثر شيء بالنسبة إليه، ‫والده "ثيودور روزفلت" الأب.
"What would I not give if only he could have lived to see me here in the White House, " the President said.	‫قال الرئيس، "كنت لأضحي ‫بأي شيء ليكون على قيد الحياة ليراني ‫هنا في (البيت الأبيض)".
Then he noticed that the flowers on the dinner table were Saffronia roses, the same variety his father had worn every day in his buttonhole.	‫ثم لاحظ أن الأزهار على مائدة العشاء ‫كانت أزهار "سافرونيا" الصفراء، ‫النوع ذاته الذي ارتداه والده ‫كل يوم في فتحة أزراره.
"I feel as if my father's hand were on my shoulder, " Roosevelt said, as if there were a special blessing	‫قال "روزفلت"، "أشعر بأن ‫يد أبي كانت على كتفي،
"over the life I am to lead here."	‫كأن هناك مباركة مميزة ‫للحياة التي سأحييها هنا."
The man and the moment were perfectly met.	‫كان الرجل واللحظة ‫التي ظهر بها متساويين تماماً.
This was America at the turn of the... what was to become and Americans already felt it...	‫كانت هذه "أمريكا"، وما ستصبح عليه ‫وكان الأمريكيون يشعرون بهذا، ‫القرن الأمريكي.
Telephones, internal combustion engines, airplanes, all kinds of stuff.	‫كانت العلوم في الهواء، ‫الهاتف، ومحركات الاحتراق الداخلي ‫والطائرات، وأشياء مختلفة أخرى.
And here came this, this man who was called a steam engine in trousers.	‫وها قد أتى هذا الرجل الذي ينعتونه ‫بلقب "المحرك البخاري في سروال".
He just embodied the moment.	‫وكان تجسيداً تاماً لذلك الوقت.
Roosevelt has the knack of doing things and doing them noisily, clamorously.	‫كانت لدى "روزفلت" نزعة الإنجاز ‫وكان يفعل هذا بشكل مزعج وصارخ
While he is in the neighborhood, the public can no more look the other way than the small boy can turn his head away from a circus parade followed by a steam Calliope.	‫عندما كان في الحي، لم يتمكن الناس ‫من إبعاد ناظريهم عنه كالطفل الصغير ‫غير القادر عن غض النظر عن موكب ‫السيرك الذي تتبعه عربة بخارية موسيقية.
Theodore Roosevelt would prove to be a brand-new kind of President for a brand-new century.	‫سيتضح أن "ثيودور روزفلت" ‫نوع جديد من الرؤساء في قرن جديد.
But at first, no one knew precisely in which direction Roosevelt would lead his parade.	‫ولكن في البداية، لم يعلم أحد ‫الوجهة التي سيقود فيها "روزفلت" موكبه.
In the decades after Abraham Lincoln, most American presidents had been content to be caretakers.	‫ففي العقود التي تلت "إبراهام لينكولن" ‫معظم الرؤساء الأمريكيين ‫اكتفوا بالاعتناء بالشعب.
Real power lay with the congress, with the party machines that controlled what did and did not happen on capitol hill, and with the financial giants whose power grew steadily and whose orders many senators followed without a second thought.	‫وكمنت القوة الحقيقية مع الكونغرس ‫والآلات الحزبية ‫التي تحكمت بما حدث أو لم يحدث ‫في "كابيتول هيل"، ومع العمالقة الماليين ‫الذين ازدادت سلطتهم بثبات
"I did not care a rap for the form and show of power, " Roosevelt remembered.	‫"لم أكترث على الإطلاق لشكل السلطة ‫وطريقة عرضها" كما تذكر "روزفلت"،
"I cared immensely for the use that could be made of the substance."	‫"بل اكترثت كثيراً للفائدة التي ‫يمكن حصدها من المادة ذاتها."
One admirer hailed him as "a stream of fresh",	‫وصفه معجب بأنه "تيار نقي من ‫الهواء العليل من الجبال والذي أرسل لتنقية
"pure bracing air from the mountains, sent to clear the fetid atmosphere of the national capital."	‫الأجواء النتنة في عاصمة البلاد."
But the novelist Henry James dismissed him as	‫لكن الروائي "هنري جايمس" ‫قلل من شأنه على أنه...
"the monstrous embodiment of unprecedented and resounding noise."	‫"التجسيد الوحشي لشيء غير مسبوق ‫ولا مثيل له وهو الضجيج". ‫"العقيد"
"You must always remember, " his friend the French ambassador warned,	‫حذره صديقه السفير الفرنسي قائلاً ‫"عليك أن تذكر دائماً
"that the President is about 6."	‫أن معدل ضجيج الرئيس ‫يصل إلى 6".
I'm no orator, and in writing, I'm afraid I'm not gifted at all.	‫"لست بالخطيب ولست موهوباً جداً ‫بالكتابة أيضاً
If I have anything at all resembling genius, it is the gift of leadership.	‫وإن تمتعت بشيء يقارب العبقرية ‫فهو في موهبة القيادة."
He was the youngest President in history, just 42;	‫كان أصغر رئيس في التاريخ، ‫عمره 42 عاماً فقط
the first to have been born in a city;	‫أول من يولد في مدينة،
The first to be known by his initials... t.R.	‫والأول الذي يعرف ‫بأحرف اسمه الاستهلالية، "تي آر"
He was an author and naturalist, bird-watcher and big-game hunter, historian and expansionist, moral crusader and shrewd politician.	‫كان مؤلفاً ومحباً للطبيعة ‫ومراقباً للطيور ‫ويحب صيد الحيوانات ‫ومؤرخاً وتوسعُي المذهب ‫ومحارباً أخلاقياً وسياسياً محنكاً.
And he was also a proud husband and father whose 6 boisterous children transformed the dark, formal executive mansion into a giant playhouse overnight.	‫وكان كذلك زوجاً ووالداً فخوراً ‫حيث حول أولاده الستة الأشقياء ‫الظلام والرسمية ‫في القسم التنفيذي إلى بيت ضخم ‫للعب في ليلة وضحاها.
He is a hyperactive adult, is what Theodore Roosevelt is, but the man is brilliant.	‫كان رجلاً كثير النشاط، ‫هذا ما كان عليه "ثيودور روزفلت" ‫لكن الرجل بالغ الذكاء.
I think he's very close to a genius, if there is such a thing as a genius.	‫أعتقد أنه قارب العبقرية ‫إن كان هناك شيء يدعى بالعبقرية
Of all the presidents of the United States.	‫من بين جميع رؤساء "الولايات المتحدة"
He could speed-read before anybody knew the expression, let alone how to do it, and quote from what he'd read 5 years later.	‫كان بإمكانه القراءة بسرعة ‫قبل اشتهار هذا المصطلح ‫ولم يكن يعرف أحد كيف يقوم بالأمر ‫وكان يقتبس مما قرأه بعد 5 سنوات.
He spoke a variety of languages terribly, almost incomprehensibly in some cases, but that didn't slow him down.	‫تحدث مجموعة لغات بشكل رديء ‫وفي بعض الأحيان، ‫بشكل لا يمكن فهمه ‫لكن هذا لم يؤخر تقدمه.
The first President to go down in a submarine;	‫كان أول رئيس ينزل داخل غواصة
The first President to leave the country during the course of his time in office;	‫وأول رئيس يغادر البلاد ‫خلال فترة حكمه
The first President to send a transatlantic cable for the purposes of diplomacy;	‫وأول رئيس يرسل برقية عبر الأطلسي ‫لأهداف دبلوماسية
The first President to own an automobile;	‫وأول رئيس يمتلك سيارة
And more important than all of those, the first President to win the nobel peace prize;	‫والأهم من هذه الأشياء كلها ‫كان أول رئيس يفوز بجائزة "نوبل" للسلام
And greater still the first President ever to invite an African American to dine with him in the White House.	‫والأعظم من هذا أيضاً ‫أنه أول رئيس على الإطلاق ‫يقوم بدعوة أمريكي من أصل إفريقي ‫لتناول العشاء معه ‫في "البيت الأبيض".
And that's a short list.	‫وهذه قائمة صغيرة.
He had pledged to "continue, absolutely unbroken, the policy of President McKinley, "	‫تعهد أن يكمل دون إحباط ‫سياسة الرئيس "ماكينلي".
but he also had a reputation for independence and unpredictability.	‫لكنه عرف أيضاً باستقلاليته ‫وصعوبة توقع تصرفاته.
He had been taught by his father to view the world in terms of right and wrong...	‫علمه والده أن ينظر إلى العالم ‫من منظور الصواب والخطأ
And to see himself always as the defender of the right.	‫وأن ينظر لنفسه دائماً ‫على أنه المدافع عن الصواب.
He carried a pulpit around with him.	‫كان يحمل منصة خطاب معه.
He really was... this bully pulpit was an appendage.	‫وكانت هذه المنصة جزءاً منه.
He was a moralist first, last and always and not one racked by doubts.	‫كان أخلاقياً في المنزلة الأولى ‫والأخيرة وطوال الوقت ‫وليس بشخص تثقله الشكوك.
He also understood modern technology.	‫كان يفهم التكنولوجيا المعاصرة أيضاً.
He understood the cycles of the newspaper business.	‫كان يفهم دورات أعمال الصحف.
He understood that he could claim center stage if he wanted to.	‫فهم أن بإمكانه التزام وسط المسرح ‫إن أراد فعل ذلك
And by claiming center stage he could get his message out to the American people in a way previous presidents often had not bothered to.	‫وبفعل هذا يمكنه إيصال رسالته ‫للشعب الأمريكي بطريقة مختلفة ‫عن الرؤساء الآخرين الذين لم يسعوا لفعلها.
Among those waiting most eagerly to see what Theodore Roosevelt would do were two young members of his own clan...	‫من بين أكثر التواقين لرؤية ماذا سيفعل ‫"ثيودور روزفلت" كان فردان صغيران من عشيرته
His orphaned niece, Eleanor, just 16, studying in england and following his activities in the newspapers, and his young fifth cousin, Franklin, a student at Harvard but already intrigued by the idea of following into politics,	‫ابنة أخيه اليتيمة "إلينور"، ‫عمرها 16 عاماً ‫وتدرس في "إنجلترا" وتتبع نشاطاته في الصحف ‫وابن عمه الخامس الشاب "فرانكلين"،
the man his mother called "your noble kinsman."	‫وهو طالب في "هارفارد" ‫وهو مهتم بفكرة اتباع السياسة ‫كالرجل الذي دعته والدته ‫"قريبك النبيل".
It was from Teddy Roosevelt that the American people first got their sense of political excitement from the President.	‫كان عن طريق "تيدي روزفلت" ‫قد حصل الشعب الأمريكي لأول مرة ‫على حسه للحماسة السياسية ‫من الرئيس.
They've looked for many things from Washington... competence, leadership, help.	‫كانوا ينتظرون أشياء كثيرة ‫من "واشنطن" كالكفاءة والقيادة والمساعدة.
But excitement?	‫ولكن الحماسة؟ ‫هذه تسلية.
October 17, 1901, the "Atlanta Constitution."	‫7 أكتوبر 1901، ‫صحيفة "أتلانتا كونستيتوشن"
Tonight, just before 8:00, a negro in evening dress presented himself at the White House door, and, giving his name, said that he was to dine with the President.	‫الليلة قبل الساعة الثامنة ‫زنجي بملابس رسمية ‫قدم نفسه أمام باب "البيت الأبيض" ‫وبإعطاء اسمه قال إنه سيتعشى مع الرئيس.
Booker Washington has made several visits to the White House and his face is known there, so he was at once admitted into the private apartment.	‫"بوكر واشنطن" زار "البيت الأبيض" ‫عدة مرات وكان وجهه مألوفاً ‫ولهذا أدخلوه إلى الشقة الخاصة في الحال.
Within hours of becoming President, Roosevelt had wired booker t.	‫بعد ساعات على توليه منصب الرئاسة ‫أرسل "روزفلت" برقية لـ"بوكر تي واشنطن"
President of the tuskegee institute and the most powerful black man in America, asking him to come and see him.	‫رئيس معهد "تاسكيغي" ‫وأكثر رجل أسود نافذ في "أمريكا" ‫طالباً منه أن يأتي ويقابله.
Each man wanted something from the other.	‫أراد كل منهما شيئاً من الآخر.
Negro citizens had been brutally and systematically disenfranchised throughout the South.	‫تعرض المواطنين الزنوج بعنف وبشكل ‫نظامي لسلب حقوقهم في الجنوب.
Washington wanted the new President's assurance that he would continue to appoint African Americans to federal jobs and resist those Republicans who wanted to crack the solid Democratic South by turning the party of Lincoln "lily white."	‫أراد "واشنطن" تأكيد الرئيس الجديد ‫أنه سيستمر بتعيين أمريكيين ‫من أصل إفريقي بوظائف فيدرالية ‫ومقاومة الجمهوريين الذين أرادوا أن يشققوا ‫الجنوب الديمقراطي الصلب
Roosevelt, on the other hand, wanted to make sure that he and he alone controlled all the black delegates to the republican convention in 1904.	‫وأراد "روزفلت" ‫بدوره أن يحرص على أن ‫يتحكم وحده بجميع المفوضين السود ‫للمؤتمر الجمهوري عام 1904.
The dinner invitation for Washington was a matter of simple courtesy, he said.	‫كانت دعوة العشاء بالنسبة ‫إلى "واشنطن" مسألة لباقة بحتة كما قال.
"The very fact that I felt a moment's qualm on inviting him"	‫"حقيقة أن راودني ارتياب مفاجىء ‫عند دعوته بسبب لونه
because of his color made me ashamed of myself and made me "send the invitation."	‫جعلتني أشعر بالخجل من نفسي ‫وجعلتني أرسل الدعوة."
A reporter for one of the wire services noticed Washington's name in the register of visitors and filed a story.	‫مراسل من إحدى خدمات القنوات مدفوعة الاجر ‫لاحظ اسم "واشنطن" ‫في سجل الزيارات ونشر القصة.
Although black slaves had built the executive mansion and black servants had waited upon all of its occupants, no black American had ever dined there before and not only had the President dined with Washington but he had done so in the company of his wife and teen-aged daughter, Alice.	‫رغم أن العبيد السود قد بنوا ‫القسم التنفيذي ‫وخدم الخادمون السود جميع ‫من دخلوه ‫ولكن لم يتناول أمريكي أسود ‫العشاء هناك مسبقاً
White men of the South, how do you like it?	‫أيها الرجال البيض في الجنوب، ‫أيعجبكم الأمر؟
White women of the South, how do you like it?	‫أيتها النساء البيضاوات في الجنوب، ‫أيعجبكن الأمر؟
The negro is not the equal of the white man.	‫الزنجي ليس مساوياً للرجل الأبيض
Mr. Roosevelt might as well try to rub the stars out of the firmament as try to erase that conviction from the hearts of the American people.	‫أن يقوم السيد "روزفلت" ‫بمحاولة محو النجوم من السماء ‫أسهل من إخراج هذا المعتقد ‫من قلوب الشعب الأمريكي.
"New Orleans times-democrat"	‫صحيفة "نيو أورلينز تايمز ديموكرات".
"The action of President Roosevelt in entertaining that nigger, "	‫"تصرُف الرئيس (روزفلت) باستضافة ‫ذلك الزنجي..."
said senator Ben tillman of South Carolina,	‫كما قال السيناتور "بين تيلمان" ‫من "كارولينا الجنوبية".
"will necessitate our killing a thousand niggers in the South before they will learn their place again."	‫"... سيتطلب قتل ألف زنجي ‫في الجنوب قبل إدراك منزلتهم مجدداً."
The President was astonished at the furor.	‫"اذهب إلى الخلف واجلس" ‫ذهل الرئيس بهذا الغضب.
"I would not lose my self- respect by fearing to have a man like booker t.	‫"الصحافة الجنوبية تندد بـ(روزفلت)" ‫"لن أفقد احترامي لذاتي ‫بالشعور بالخوف" ‫"لاستضافة رجل مثل (بوكر تي واشنطن) ‫على العشاء"، كما كتب.
Washington to dinner, " he wrote, " if it cost me every political friend I have got."	‫"حتى لو كلفني هذا جميع ‫أصدقائي السياسيين."
Washington remained Roosevelt's most important	‫بقي "واشنطن" بالنسبة إلى "روزفلت" ‫أهم حليف أمريكي من أصل إفريقي
African-American ally, but the President never again asked him or any other black person, to dine at the White House.	‫لكن الرئيس لم يدعه مجدداً ‫أو أي شخص أسود آخر ‫للعشاء في البيت الأبيض.
When Theodore Roosevelt became President, industrial production had never been higher or the profits greater.	‫عندما أصبح "ثيودور روزفلت" رئيساً ‫لم يسبق للإنتاج الصناعي أن يكون ‫بمثل هذه المعدلات المرتفعة ‫أو الأرباح أكبر.
But only a handful of men dominated American finance and industry and reaped those profits.	‫لكن رجالاً قلائل سيطروا ‫على الأموال الأمريكية ‫وكذلك الصناعة وحصدوا هذه الأرباح.
Through the manipulation of some 250 big interlocking, interstate corporations...	‫عن طريق التلاعب بحوالي ‫250 شركة ضخمة متصلة بين الولايات
Monopolistic trusts...	‫واحتكار الاستثمارات
They dictated the rates farmers paid to ship their products and the wages and hours and conditions industrial workers had to accept.	‫حددوا الأتعاب التي تدفع للمزارعين ‫كي يصدروا منتجاتهم ومرتبات وساعات ‫وكذلك الظروف ‫التي كان على العمال الصناعيين ‫القبول بها.
They decided the cost to consumers of everything:	‫لقد قرروا أسعار جميع المواد ‫التي يستخدمها المستهلك
From coal to whiskey, canned carrots to lamp oil.	‫من الفحم إلى الـ"ويسكي" ‫إلى الجزر المعلب وزيت المصابيح.
And they destroyed small businessmen who dared try to compete with them.	‫ودمروا رجال الأعمال الصغار ‫الذين تجرؤوا على منافستهم.
J. Pierpont Morgan, the new York financial titan, who had been a friend of the President's father, spoke for most of the men who ran the trusts when he said,	‫"جاي بيبونت مورغان"، ‫عملاق الاستثمارات في "نيويورك" ‫والذي كان صديقاً لوالد الرئيس ‫تحدث نيابة عن أغلب الرجال الذين ‫أداروا الاستثمارات عندما قال
"I owe the public nothing."	‫"لا أدين للعامة بشيء."
That attitude was anathema to Theodore Roosevelt.	‫كان موقفهم هذا بمثابة لعنة ‫بالنسبة إلى "ثيودور روزفلت".
He had a patrician scorn for mere wealth and an inbred sense of responsibility toward society.	‫كان لديه حقد أرستقراطي المنبع ‫للثراء الفاحش ‫وكان لديه حس فطري بالمسؤولية ‫تجاه المجتمع.
I have been in a great quandary over trusts.	‫أنا في مأزق كبير بالنسبة للاستثمارات.
I do not know what attitude to take.	‫لا أعرف أي موقف أتخذ.
I do not intend to play a demagogue.	‫لا أنوي لعب دور المحرض.
On the other hand, I do intend to see that the rich man is held to the same accountability as the poor man, and when the rich man is rich enough to buy unscrupulous advice from very able lawyers, this is not always easy.	‫لكني أنوي أن أجعل الرجل الثري يتحمل ‫المسؤولية ذاتها كما يفعل الرجل الفقير ‫وعندما يكون الثري ثرياً كفاية ‫لشراء نصيحة عديمة الضمير من محام مقتدر ‫فالأمر ليس سهلاً دائماً.
I think Roosevelt understood that the trusts were important but they were getting out of control.	‫أعتقد أنّ "روزفلت" فهم أن الاستثمارات مهمة ‫لكنها كانت تخرج عن السيطرة.
When, the Constitution was written in 1787, there were no corporations, there were almost no banks.	‫عندما تمت كتابة الدستور عام 1787 لم تكن ‫هناك شركات ضخمة وبالكاد كانت هناك مصارف
So all this had sprung up in the 19th century and particularly after the civil war.	‫لذا ظهر كل هذا في القرن الـ19 ‫وخاصة بعد الحرب الأهلية.
The only counterweight to capitalism is government.	‫المواجهة الوحيدة للرأسمالية ‫هي الحكومة.
Labor would like to be the counterweight but it isn't quite yet.	‫تود الطاقة العمالية أن تكون كذلك ‫لكنها ليست كذلك في الحقيقة.
So the one entity that can really create a restraining mechanism on runaway capitalism is government.	‫لذا الهيئة الوحيدة التي يمكنها أن تشكل ‫ضغطاً على الآلية الرأسمالية هي الحكومة.
And if the Constitution doesn't seem to want that, we're gonna do it anyway.	‫وإن لم يكن الدستور يريد هذا ‫فسنفعل هذا على جميع الأحوال.
On February 18, 1902, without any warning, the President ordered his justice department to file suit against one of the trusts in which j.P. Morgan had a major interest, the northern securities company.	‫في 18 فبراير 1902 ‫ودون أي تحذير ‫أمر الرئيس وزارة العدل ‫أن ترفع قضية ‫ضد أحد الاستثمارات التي كان ‫لـ"جاي بي مورغان" اهتمام كبير بها،
Its goal was the monopolistic control of all of the rail roads between the Great Lakes and the Pacific Ocean.	‫كان هدفها احتكار جميع السكك الحديدية ‫بين البحيرات العظمى والمحيط الهادىء.
Morgan was stunned.	‫شعر "مورغان" بالصدمة.
He hurried to the White House.	‫أسرع إلى "البيت الأبيض".
"If we have done anything wrong, " he told the President,	‫أخبر الرئيس، ‫"إن فعلنا شيئاً خاطئاً،
"send your man to my man and they can fix it up."	‫فأرسل رجلك إلى رجلي ‫ويمكنهما إصلاح الأمر."
"That can't be done, " the President said.	‫رد الرئيس، "لا يمكن فعل هذا".
"We don't want to fix it up, " his Attorney General philander knox added, "we want to stop it."	‫وأضاف المدعي العام لديه ‫"لا نريد إصلاح هذا..." ‫واسمه "فيلاندر نوكس" ‫"... بل نريد أن نوقفه".
Morgan asked if the administration planned to attack any of his other interests.	‫سأل "مورغان" إن كانت الإدارة ‫تنوي مهاجمة أي مصالح أخرى له.
Roosevelt replied, not unless they'd done something wrong.	‫ورد عليه "روزفلت" قائلاً ‫"ليس إن لم يرتكبوا خطأ."
The supreme court would eventually uphold	‫في النهاية حافظت المحكمة العليا ‫على قرارات "روزفلت"
Roosevelt's actions, finding northern securities had been in illegal restraint of trade.	‫ووجدت أن شركة "نورثرن سيكيوريتيز" ‫تمارس التجارة غير القانونية.
The President never directly challenged Morgan again, but he would invoke the sherman anti-trust act against	‫لم يتحد الرئيس "مورغان" ‫مباشرة مجدداً ‫لكنه قدم قانون "شيرمان" للاستثمارات ‫ضد 40 عملية استثمار أخرى خلال رئاسته
40 other trusts during his presidency, more than all 3 of his predecessors combined.	‫وهذا يفوق الرؤساء الثلاثة السابقين ‫له مجتمعين.
He did not believe that economic concentration in itself was bad, but he was confident the federal government had the power and the moral duty to curb its worst excesses.	‫لم يؤمن بأن التركيز الاقتصادي ‫بذاته سيىء، ‫لكنه كان واثقاً ‫من أن الحكومة الفيدرالية لديها القوة ‫والواجب الأخلاقي لكبح ‫أسوأ حالات مبالغاته.
What was new in urban life, what was new in all these cities into which immigrants were pouring as never before, what was new was a kind of interconnectedness, a sense in which what happened in Wisconsin to the price of milk	‫ما كان جديداً في الحياة الحضرية ‫والجديد في كل هذه المدن التي تدفق ‫إليها المهاجرون بشكل لا سابقة له ‫ما كان جيداً هو نوع من التشابك
and what happened in Cincinnati to the price of pork, and what happened to the railway costs of shipping goods to the east and out to the west and elsewhere, affected everybody.	‫وما حدث في "سينسيناتي" ‫لأسعار لحم الخنزير ‫وما حدث لتكاليف شحن ‫البضائع بالقطارات إلى الشرق ‫وإلى الغرب وإلى أي مكان ‫أثر في الجميع.
Therefore, the federal government as the unifier of the nation was implicitly involved in everything.	‫ولهذا الحكومة الفيدرالية ‫كالعامل الموحد للأمة ‫كان لها علاقة ضمنية بكل شيء.
This was the beginning, at the beginning of the 20th century, what the 20th century became in America:	‫كانت هذه بداية القرن العشرين ‫وهو ما آل القرن العشرين ‫إليه في "أمريكا"
A great centralizing nation-creating force.	‫قوة مركزية هائلة تخلق الأمة.
The great corporations are the creatures of the state, and the state not only has the right to control them, but it is in duty bound to control them wherever need of such control is shown.	‫الشركات الضخمة هم المخلوقات ‫التي تملكها الدولة، ‫ولا يحق ‫للدولة فقط أن تتحكم بها ‫بل إن التحكم بها من واجباتها ‫عندما تظهر حاجة لمثل هذه السيطرة.
Government was to be a countervailing power.	‫كان على الحكومة أن تكون ‫قوة موازية
It's almost the language of newtonian physics, the language of our Constitution, checks and balances.	‫إنها كلغة قوانين "نيوتن" للفيزياء ‫إنها لغة دستورنا، الضوابط والموازين
This was checks and balances outside the Constitution.	‫كانت هذه ضوابط وموازين ‫خارج الدستور.
That the meat trust and the steel trust and the oil trust were big, maybe they're beneficial, maybe they're inevitable, but they should not operate alone.	‫أن استثمارات اللحوم والفولاذ ‫وكذلك النفط ‫كانت كبيرة وربما تكون مفيدة ‫وقد يكون لا مفر منها ‫ولكن عليها ألا تعمل وحدها.
The government must grow to reach up to where they were.	‫على الحكومة أن تكبر ‫حتى تصل إلى حيث كانوا.
I wonder how a man so thick-set, of rather abdominal contour, with eyes heavily spectated, could have so much an air of magic and wild romance about him, could give one so stirring an impression of adventure	‫"أتساءل كيف يكون رجل ‫غليظ البنية وبمعدة كبيرة ‫بعينين تغطيهما نظارة سميكة ‫يحمل كل هذا الكم من السحر ‫والرومانسية الجامحة
and chivalry.	‫ويمكن أن يعطي المرء انطباعاً ‫قوياً بالمغامرة والنخوة."
The "metropolitan magazine."	‫مجلة "ميتروبوليتان".
Fueled by cup after cup of coffee, served to him in a special mug his eldest son said was as big as a bathtub,	‫متأثراً بكوب تلو الآخر من القهوة ‫مقدمة له في كوب خاص ‫وصفه ابنه الأكبر على أنه ضخم
Theodore Roosevelt raced through his day.	‫عمل "ثيودور روزفلت" جاهداً ‫كل يوم.
Letters were answered upon receipt...	‫تمت الاجابة عن الرسائل حال وصولها ‫وبلغ عددها 150 ألف رسالة
A lifetime total of 150,000, dictated to shifts of weary stenographers.	‫ملقنة لأفواج من الكتاب ‫المختزلين المرهقين.
Jefferson wrote 22,000 letters, and we regard him as one of the great correspondents in American history.	‫كتب "جفرسون" 22 ألف رسالة ‫وقد اعتبرناه ‫كأحد أعظم المراسلين ‫في التاريخ الأمريكي.
Roosevelt wrote at least 150,000 letters.	‫كتب "روزفلت" 150 ألف رسالة ‫على الأقل
He's the writing-est President in American history, by far.	‫إنه أكثر رئيس في "أمريكا" ‫قام بكتابة الرسائل
And a number of his books are American classics.	‫وإن عدداً من كتبه تعد ‫من الكتب الكلاسيكية الأمريكية. ‫لذا فهو مفكر.
So he's an intellectual.	‫كان يقرأ كتاباً في اليوم ‫وأحياناً ثلاثة كتب.
He read a book a day, sometimes 3 books in a day when he had some leisure.	‫عندما كان لديه بعض وقت الفراغ.
You think of Jefferson as America's renaissance man, but it's really Roosevelt.	‫نحن نفكر في "جفرسون" على أنه رجل ‫النهضة لـ"أمريكا" لكنه في الواقع "روزفلت".
He would not stop talking.	‫لم يكن يتوقف عن الكلام.
He was a one-man gasbag.	‫كان رجلاً يخرج غازات ‫بطنه كثيراً.
But it was so interesting that most people didn't mind.	‫والمثير للاهتمام أن أغلب الناس ‫لم يمانعوا هذا.
One of my favorite stories is, when he heard that there was a famous big game hunter in Washington, and he said to some of the people on his staff, "get that man over here.	‫إحدى قصصي المفضلة هي أنه عندما ‫سمع بوجود صياد شهير في "واشنطن" ‫وقال لبعض الأشخاص في طاقمه ‫"أحضروه إلى هنا، أود أن أقابله فعلاً."
I'd really like to meet him." So the this big, strapping, English fellow was taken into the President's office.	‫تم إدخال هذا الرجل ‫الإنجليزي القوي إلى مكتب الرئيس.
And the door was closed and people outside the office heard this talking going on.	‫وتم إغلاق الباب ‫والأشخاص خارج المكتب سمعوا حديثاً مستمراً.
Finally the man emerged about an hour and a half later looking just beat down, just as though he'd been through a storm.	‫وفي النهاية ظهر الرجل بعد ساعة ‫ونصف تقريباً ‫وكان يبدو مرهقاً وكأنه مر ‫بعاصفة.
And one of the President's staff said, "what did you tell" the President?"	‫وقال أحد أفراد طاقم الرئيس ‫"بم أخبرت الرئيس؟"
He said, "I told him my name."	‫قال "لقد أخبرته باسمي."
We love him because of the energy.	‫نحن نحبه بسبب طاقته.
His laugh was infectious.	‫كانت ضحكته معدية.
His son Ted said, "my father had" a dozen eggs for breakfast every morning."	‫قال ابنه "تيد"، "كان والدي يتناول ‫12 بيضة على الإفطار كل صباح".
So he's a large man, and he's larger-than-life.	‫إذن فهو رجل ضخم ‫وطموحه لا حدود له.
Roosevelt once said, "there's nothing quite so exhilarating"	‫قال "روزفلت" ذات مرة ‫"لا شيء مبهج أكبر
as being thrown over the shoulders of a 300-pound Japanese man."	‫من أن يحملك رجل ياباني وزنه ‫140 كغ على كتفه."
He played all these wild games in the White House.	‫كان يمارس ألعاباً جامحة ‫في "البيت الأبيض".
He wrestled with diplomats.	‫كان يصارع الدبلوماسيين.
He played a game called single stick with Leonard Wood in which they would wrap themselves up in cushions and then beat the living daylights out of each other with sticks until Roosevelt had to stop.	‫كان يمارس لعبة اسمها "عصا واحدة" ‫مع "لينورد وود" ‫حيث كانا يلفان أنفسهما بالوسائد ‫ثم يضربان بعضهما البعض بشدة بالعصي
He boxed with a young aide, too, until a blow caused him to lose vision in his left eye.	‫ومارس الملاكمة مع مساعد شاب لديه ‫حتى قامت ضربة ‫بالتسبب بفقدان بصره ‫في العين اليسرى.
"Accordingly I thought it better to acknowledge that I had become an elderly man and would have to stop boxing, "	‫"أعتقد أن من الأفضل أن أعترف ‫بأنني هرمت وعلي أن أتوقف ‫عن ممارسة الملاكمة."
he remembered.	‫كما ذكر.
"I then took up jiujitsu for a year or two."	‫"ثم مارست الـ(جوجيتسو) لعام ‫أو اثنين."
Photographers were forbidden to cover his daily tennis games because he thought voters considered tennis a rich man's pastime.	‫منع المصورون من تغطية ‫لعبه التنس الأرضي يومياً ‫لأنه اعتقد أن الناخبين يعتقدون أن التنس ‫الأرضي طريقة يضيع الأثرياء فيها وقتهم.
But when a cameraman failed to capture his horse jumping over an obstacle, he was more than happy to make the jump again.	‫ولكن عندما أخفق مصور بالتقاط ‫صورته وهو يقفز بحصانه فوق حاجز ‫كان مستعداً وسعيداً ‫لإعادة القفزة مجدداً.
"Roosevelt bit me, " the editor William Allen White said,	‫قال المحرر "ويليام آلن"، ‫"لقد عضني (روزفلت)...
"and I went mad."	‫وأُصبت بالجنون".
In the late summer of 1902,	‫في أواخر صيف 1902
Roosevelt set out on a two- week tour of New England, campaigning for trust reform.	‫انطلق "روزفلت" في رحلة مدتها ‫أسبوعان في "نيو إنغلاند" ‫يقوم بحملة من أجل إصلاح ‫الاستثمارات.
He was on his way to speak at the Pittsfield, Massachusetts, country club on September 3rd...	‫كان في طريقه ليلقي خطاباً في "بيتسفيلد"، ‫"ماساتشوستس" في النادي الريفي في 3 سبتمبر
When a trolley car slammed into his carriage.	‫عندما اصطدمت بعربته ‫عربة جر
His bodyguard was killed.	‫ومات حارسه الشخصي.
Roosevelt was hurled 30 feet, landed on his face, and badly injured his left shin.	‫أُلقي بـ"روزفلت" 10 أمتار ‫وسقط على وجهه ‫وأصيبت عظمة ساقه اليسرى ‫إصابة خطرة. ‫"إجراء جراحة ثانية لـ(روزفلت)"
He was forced to spend several weeks in a wheelchair, confronted now with a new crisis that threatened not only the nation's economy but his own political survival.	‫أجبر على قضاء بضعة أسابيع ‫بكرسي متحرك ‫مواجهاً أزمة أخرى ‫لا تهدد اقتصاد البلاد فحسب ‫بل حياته السياسية.
Coal mining is a business... Not a religious, sentimental, or academic proposition.	‫"إن التنقيب عن الفحم عمل وليس بديانة ‫أو بأمر عاطفي أو مقترح أكاديمي.
The rights and interests of the laboring man will be protected and cared for not by the labor agitators, but by the Christian men to whom God in his infinite wisdom has given control of the property interests of the country.	‫إن حقوق وفوائد الرجل العامل ‫ستتم حمايتها والاعتناء بها ‫ليس عن طريق العمال المشاغبين ‫بل عن طريق رجال مسيحيين
George f. Baer, President, Philadelphia  reading coal and iron company.	‫"جورج إف باير"، رئيس شركة ‫"فيلادلفيا آند ردينغ" للحديد والفحم.
America ran on anthracite coal, much of it mined from Pennsylvania hillsides.	‫عملت "أمريكا" على فحم الـ"أنثراسايت" ‫وأغلبه نقب عنه في تلال "بنسلفانيا".
It was a nightmarish business.	‫كان عملاً مروعاً.
16-hour days.	‫16 ساعة في اليوم.
The constant threat of cave-ins and explosions.	‫تهديد مستمر بالانهيارات والانفجارات.
Boys as young as 10 breaking big chunks into small ones.	‫أطفال بعمر 10 سنوات يكسرون ‫قطعاً كبيرة إلى قطع أصغر.
Low wages that had not been raised for more than 20 years...	‫ومرتبات منخفضة ‫لم تعدل منذ 20 عاماً
And company-owned stores intended to swallow up what little money the miners could scrape together.	‫ومتاجر تملكها الشركة ‫تنوي ابتلاع أي أموال ‫قليلة جناها عاملو المناجم.
And dominating all of it, mine owners adamantly opposed to change.	‫للسيطرة على كل هذا، ‫عارض أصحاب المناجم التغيير دائماً.
In the spring, the united mine workers union had called for a strike.	‫في الربيع، بدأت نقابة عمال ‫المناجم المتحدة إضراباً.
140,000 men laid down their pick axes.	‫140 ألف رجل وضعوا فؤوسهم ‫على الأرض.
Management refused even to hear their grievances.	‫رفضت الإدارة سماع شكواهم حتى.
Over the next several months, the price of coal rose from $5.00 to $30 a ton.	‫وفي الأشهر التالية ارتفعت أسعار الفحم ‫من 5 دولارات إلى 30 للطن الواحد.
Winter was coming.	‫"76584" ‫كان الشتاء قادماً.
Homes would remain unheated.	‫كانت ستبقى البيوت من دون دفء.
Roosevelt believed there was a real chance of what he called	‫اعتقد "روزفلت" أن هناك فرصة ‫كبيرة لما يدعوه
"the most awful riots this country has ever seen."	‫"أفظع شغب تشهده البلاد."
The administration was sure to take the blame.	‫وكانت الحكومة ستتلقى اللوم.
And Roosevelt decided for the good of the country that he needed to intervene.	‫قرر "روزفلت" من أجل مصلحة البلاد ‫أن عليه التدخل.
The problem was he had no constitutional authority of any sort to intervene.	‫المشكلة أنه لم يتمتع بالصلاحية الدستورية ‫لهذا النوع من التدخل.
The President summoned both sides to Washington to discuss what he called "a matter of vital"	‫استدعى الرئيس الطرفين إلى "واشنطن" ‫ليناقشا ما دعاها
concern to the whole nation."	‫"مسألة هامة تخص البلاد كاملة."
Roosevelt holds them together and he says, "gentlemen", I want you to agree to arbitrate."	‫يجمعهم "روزفلت" معاً ويقول لهم "أيها السادة ‫أريدكم أن توافقوا على التحكيم بينكم."
And the coal operators say, "no way, we're not doing it." We don't have to."	‫وقال مندوب شركات الفحم ‫"مستحيل، لن نفعل هذا فليس علينا فعل هذا."
And Roosevelt says, "very well then."	‫وقال "روزفلت" بعدها،
"I will nationalize the mines and use the United States army to run them for the good of this people."	‫"حسناً، سأقوم بتأميم المناجم وأستخدم جيش ‫(الولايات المتحدة) لإدارتها لمصلحة الناس."
And they all say, "you have no constitutional authority" of any sort to do that."	‫وقالوا له، "ليست لديك صلاحية ‫دستورية لفعل أي من هذا."
And he says, "I know I don't."	‫وأجاب "أعرف هذا...
"The President has a moral duty to the American people that is	‫ولكن لدى الرئيس واجب أخلاقي ‫تجاه الشعب الأمريكي
"higher than his constitutional duty. And by Godfrey, I'm gonna do it if I have to."	‫وهو واجب أسمى من الواجب الدستوري ‫وأقسم إني سأمارسه إن اضطررت لذلك."
A conservative congressman confronted the President.	‫واجه أحد أعضاء الكونغرس المحافظين ‫الرئيس.
"What about the Constitution of the United States?" He asked.	‫وسأله "ماذا عن دستور البلاد؟
"How could private property be put to public purposes without due process of law?"	‫كيف يمكن وضع ممتلكات خاصة ‫بين أيدي العامة ‫من دون إجراءات قانونية كاملة؟"
Roosevelt grasped his visitor's lapels.	‫أمسك "روزفلت" بطيات ‫معاطف زائريه
"The Constitution was made for the people and not the people "for the Constitution, " he said.	‫وقال "أُعد الدستور للناس ‫ولم يوجد الناس من أجل الدستور."
The mine owners retreated, but only slightly.	‫تراجع مالكو المناجم ولكن قليلاً فقط.
They agreed to follow the suggestions of a presidential commission provided no member of the united mine workers union sat on it.	‫ووافقوا على اتباع مقترحات ‫اللجنة الرئاسية ‫ولكن بشرط ألا يكون أحد أعضاء نقابة ‫عمال المناجم فيها.
But Roosevelt was determined that labor have a voice and appointed the head of the rail road conductor's union, instead.	‫لكن "روزفلت" كان مصراً ‫على حصول العمال على صوتهم ‫وعين رئيس نقابة مرشدي ‫السكك الحديدية كبديل.
The owners objected until the President told them, with a straight face, that he was naming him as a "sociologist, " not a union man.	‫اعترض الملاك حتى أخبرهم الرئيس ‫بوجه صارم الملامح أنه سيعينه ‫كعالم اجتماعي ‫وليس كعضو في النقابة.
I shall never forget the mixture of relief and amusement I felt when I thoroughly grasped the fact that while they would heroically submit to anarchy rather than have tweedledum, yet if I would call it tweedledee, they would accept it with rapture;	‫لن أنسى مزيج الشعور بالراحة ‫والمتعة عندما فهمت حقيقة ‫أنهم مستعدون للخضوع للفوضى ‫ببطولية بدلاً من قبول الأمر ‫لكن لو منحته اسماً مختلفاً ‫كانوا سيقبلونه بفرح
It gave me an illuminating glimpse into one corner of the mighty brains of these "captains of industry."	‫"التاريخ، مصير الذين ‫اعتقدوا يملكون الأرض" ‫منحني هذا النظرة المنيرة على زاوية ‫من زوايا عقل هؤلاء "القادة الصناعيين". ‫استمر ملاك المناجم
The mine owners continued to refuse to recognize the union, but they did agree to a 10% pay raise and a 9-hour day.	‫برفض الاعتراف بالنقابة ‫لكنهم وافقوا على... ‫زيادة الدخل بنسبة 10 بالمائة ‫وتسع ساعات عمل يومياً فقط.
The strike ended.	‫انتهى الإضراب.
American homes would be heated and in the midterm elections, the Republicans would maintain majorities in both houses of congress.	‫ستتم تدفئة البيوت الأمريكية، ‫وفي انتخابات منتصف مدة الحكم ‫احتفظ الجمهوريون بالأغلبية ‫في كلا فرعي الكونغرس.
Roosevelt was jubilant.	‫كان "روزفلت" مغتبطاً.
He was the first President to mediate a labor dispute, the first to treat labor as a full partner, the first to threaten to employ federal troops to seize a strike-bound industry.	‫كان أول رئيس ‫يتوسط لحل خلاف عمالي. ‫وأول من يعامل العمال ‫كشريك كامل ‫وأول من يهدد بإرسال قوات فيدرالية ‫للسيطرة على الصناعة التي تعاني من الإضراب.
And it had all worked.	‫وقد نجح كل شيء.
Cambridge, Massachusetts. October 26, 1902.	‫"كامبريدج"، "ماساتشوستس" ‫26 أكتوبر 1902.
Dearest mama, it has been very chilly here for the past week, and the Harvard buildings have been cold through lack of fuel, but now that the strike is settled, the coal has begun to come in small quantities.	‫"أمي العزيزة، كان الطقس بارداً ‫هنا في الأسبوع الأخير ‫وبناية (هارفارد) كانت باردة ‫بسبب نقص الوقود ‫ولكن بما أن الإضراب قد انتهى ‫بدأ الفحم بالوصول بكميات قليلة
In spite of the President's success in settling the trouble,	‫وبرغم نجاح الرئيس في حل المشكلة.
I think that he makes a serious mistake in interfering... politically, at least.	‫أعتقد أنه ارتكب خطأ ‫بهذا التدخل، على الأقل سياسياً.
His tendency to make the executive power stronger than the houses of congress is bound to be a bad thing, especially when a man of weaker personality succeeds him in office.	‫نزعته في جعل القوة التنفيذية ‫أكبر من مجالس الكونغرس سيئة في النهاية ‫وخاصة عندما يخلفه رجل ‫شخصيته أضعف في المنصب.
Ever with love, f.D.R.	‫مع حبي الخالص (إف دي آر)."
Franklin Roosevelt was a Harvard sophomore now and echoing the conservative opinions of classmates whose well-to-do parents were appalled at his cousin's willingness to deal directly with labor.	‫"فرانكلين روزفلت" ‫في السنة الثانية في "هارفارد"، ‫وكان يردد الآراء المحافظة ‫زملاؤه ذوو الآباء الأثرياء ‫وكان مذعوراً من استعداد ابن عمه ‫على التعامل مباشرة مع العمال.
His own mother disagreed.	‫والدته عارضت الأمر.
"One cannot help loving and admiring him the more for it, "	‫قالت لابنها، "لا يسع المرء سوى حبه ‫والإعجاب به أكثر لهذا."
she told her son, "when one realizes that he tried to"	‫"عندما يدرك المرء أنه حاول ‫تصحيح الخطأ".
When James Roosevelt, Franklin's father, had died in 1900, Sara moved to Boston to be closer to her son.	‫عندما توفي "جايمس روزفلت" ‫والد "فرانكلين" عام 1900، ‫انتقلت "سارة" إلى "بوسطن" ‫لتكون قريبة أكثر من ابنها.
She interested herself in every aspect of his life, exulted in his successes and overlooked his failures, just as she always had.	‫اهتمت بجميع زوايا حياته. ‫فرحت بنجاحاته وتجاهلت عيوبه ‫كما فعلت دائماً.
Successes did not come easily.	‫لم يأت النجاح بسهولة.
He was not an outstanding student or especially well-liked by his classmates.	‫فلم يكن طالباً متميزاً ولم يحبه ‫زملاؤه أيضاً
Many of them thought him an over-eager lightweight, just as his schoolmates at Groton had.	‫نظر إليه أغلبهم على أنه ‫ضعيف وكثير التوق ‫كما فعل زملاء دراسته في "غروتون".
He did become the editor of the "Crimson, " and scored a minor scoop when he learned his famous cousin was coming to Cambridge, but when he ran for class marshal he lost.	‫أصبح محرراً لصحيفة "كريمزون" ‫وحقق سبقاً صحفياً صغيراً عندما علم ‫أن ابن عمه الشهير قادم ‫إلى "كامبريدج"، ‫لكنه عندما ترشح ‫ليكون رئيس الصف خسر.
Still too slight for sports, he led cheers at a football game...	‫وكان ضعيفاً على ممارسة الرياضة ‫فقام بقيادة الهتافات في مباريات كرة القدم
Though he admitted it made him feel "like a damned fool"	‫رغم أنه اعترف أن هذا جعله يشعر
waving my arms and legs before several thousand "amused spectators."	‫"كالمغفل اللعين، ألوح بذراعي وساقي ‫أمام بضعة آلاف من المشجعين المستمتعين."
He was elected to several clubs, and fully expected an invitation to join Harvard's most exclusive club, the porcellian.	‫تم اختياره لنواد متعددة وتوقع دعوة ‫للانضمام إلى نادي "هارفارد" الأكثر حصرية ‫"ذا بورسيليان".
His own father had been an honorary member;	‫فقد كان إرثاً في نهاية الأمر، ‫فقد كان والده عضواً شرفياً
His famous cousin, Theodore, belonged.	‫وابن عمه الشهير ‫"ثيودور" كان عضواً فعلياً.
But Franklin was blackballed, probably by someone who knew him at Groton, which made it even worse.	‫ولكن تم التصويت بالرفض لـ"فرانكلين" ‫في الغالب عن طريق شخص عرفه في "غروتون" ‫مما جعل الأمر أسوأ.
As always, he let no one know how hurt he was, but 15 years later, he would confide to a young relative that his rejection by porcellian had been the "greatest"	‫كالعادة، لم يعلم أحد بمدى ألمه ‫ولكن بعد 15 عاماً ‫يأتمن قريباً أصغر منه سناً ويخبره ‫إن الرفض في نادي "ذا بورسيليان"
"disappointment" of his life.	‫كان أكبر خيبة أمل في حياته.
He was disappointed in love, as well.	‫خاب أمله في الحب أيضاً.
Alice Sohier was the beautiful daughter of a wealthy Massachusetts yachtsman...	‫كانت الجميلة "أليس سوير" ‫ابنة ثري يصنع اليخوت في "ماساتشوستس".
The "loveliest" debutante of her year, Franklin remembered...	‫أجمل فتاة حديثة الظهور ‫كما تذكرها "فرانكلين"
And after courting her for several months he asked her to marry him.	‫وبعد التودد إليها بضعة أشهر ‫طلب منها الزواج به.
One day he hoped to be President like his fifth cousin, he told her, and he hoped to have no fewer than 6 children, the same number that now called the executive mansion home.	‫كان يأمل أن يصبح رئيساً ذات يوم ‫مثل ابن عمه كما أخبرها ‫وأمل ألا ينجب أقل من ستة أطفال ‫العدد ذاته الذي يملأ ‫منزل القسم التنفيذي الآن.
Alice turned him down.	‫رفضت "أليس" طلبه.
Later, she would say that she'd rejected his proposal in part because "I did not wish to become a cow."	‫لاحقاً، قالت إنها رفضت طلبه لأنها ‫"لا ترغب في أن تصبح كالبقرة."
Franklin never told his mother about Alice, and to ensure she did not know too much about his private life, had used a secret code in his terse diary.	‫لم يخبر "فرانكلين" والدته عن "أليس" ‫ليحرص على ألا ‫تعرف الكثير عن حياته الشخصية ‫كان قد استخدم رمزاً سرياً ‫في مذكراته الملخصة.
But within weeks of his parting with Alice Sohier in the late summer of 1902, a new name began to appear in its pages.	‫ولكن بعد أسابيع من افتراقه ‫عن "أليس سوير" في أواخر صيف 1902 ‫بدأ اسم جديد بالظهور ‫في هذه الصفحات.
I have always been fond of the old west African proverb:	‫طالما كنت معجباً بالمثل ‫الغرب إفريقي القائل
"Speak softly and carry a big stick and you will go far."	‫"تحدث بهدوء واحمل عصا كبيرة ‫وستنجز الكثير."
The American expansionism Roosevelt had advocated since long before his days at the Navy department had succeeded beyond his dreams.	‫التوسعية الأمريكية التي دعمها ‫"روزفلت" حتى قبل أيامه في البحرية ‫قد نجحت أكثر مما حلم.
The United States was now a world power.	‫اصبحت "الولايات المتحدة" الآن ‫قوة عالمية.
It had annexed Hawaii, driven Spain from the new world, dominated Cuba and Puerto Rico, wrested the Philippines from the Spanish and then begun a brutal, bloody campaign to subjugate the philippine people, who wanted to be free of foreign rule by anyone, including Americans.	‫لقد ضمت "هاواي" لها وقادت ‫"أسبانيا" خارج العالم الحديث ‫وسيطرت على "كوبا" و"بورتو ريكو" ‫ونزعت "الفلبين" من الأسبان
Tens of thousands died so that the United States could gain a foothold in the pacific.	‫مات عشرات الآلاف حتى تحصل ‫"الولايات المتحدة" ‫على موطىء قدم في المحيط الهادىء.
To anti-imperialists, like mark twain, such military adventures betrayed American principles and Roosevelt himself was nothing more than a "showy charlatan."	‫بالنسبة لمعادي الإمبريالية ‫مثل "مارك تواين" ‫فإن العمل العسكري المماثل هو ‫خيانة لمبادىء "أمريكا" ‫وكذلك "روزفلت" ‫ذاته ليس إلا "محتال متظاهر".
I am an anti-imperialist.	‫"أنا معاد للإمبريالية
I am opposed to having the eagle put its talons on any other land.	‫ولا أوافق على أن يزرع النسر مخالبه ‫في أي أرض أخرى"
Criticism did not much concern Theodore Roosevelt.	‫لم يهتم "ثيودور روزفلت" للانتقادات
He divided the world into what he called "civilized" nations industrialized and mostly white...	‫فقد قسم العالم إلى ما يدعوه ‫"الشعوب المتحضرة" ‫وهي صناعية وأغلبها من البيض
And "uncivilized" nations that produced raw materials, bought products instead of manufacturing them, and were incapable, he believed, of self-government.	‫و"شعوب غير متحضرة" ‫والتي أنتجت المواد الخام ‫وتقوم بشراء المنتجات بدلاً من صنعها ‫وهم غير قادرين ‫كما اعتقد على حكم أنفسهم.
The great enemy of civilization was what he called "chaos."	‫إن عدو التحضر العظيم ‫كما دعاه هو "الفوضى".
To combat it, it was the duty of "civilized and orderly" "powers" to police the rest.	‫لمحاربة الفوضى فإن مهمة ‫القوى المتحضرة والمنظمة أن تحكم العالم.
Britain should be responsible for India and Egypt.	‫على "بريطانيا" أن تكون مسؤولة ‫عن "الهند" و"مصر".
Japan...	‫"اليابان" والتي أعدها "روزفلت" ‫بين الشعوب المتحضرة
Which Roosevelt now numbered among the "civilized" nations because it had become an industrial and military power... Should control Korea and the Yellow Sea.	‫لأنها أصبحت دولة صناعية وعسكرية ‫عليها التحكم بـ"كوريا" والبحر الأصفر.
And the United States, and only the United States, must police the Western hemisphere.	‫و"الولايات المتحدة" وحدها فقط ‫يجب أن تحكم العالم الغربي.
It was called the Roosevelt corollary to the Monroe doctrine.	‫كانت تدعى بلازمة "روزفلت" ‫لمعتقدات "مونرو".
I don't think Americans by nature are very comfortable with imperialism and never were.	‫لا أعتقد أن الأمريكيين بطبيعتهم مرتاحون ‫للإمبريالية ولم يكونوا كذلك يوماً.
And had he tried to be more imperialistic than he was, he would have been stopped.	‫وإن حاول أن يكون إمبريالياً ‫أكثر مما كان عليه كانوا سيوقفونه.
I think he believed in power.	‫أعتقد أنه آمن بالقوة.
He was not as good as he should have been in dealing with foreign nations and particularly if he thought they were inferior to our way of life or to us as a people.	‫لم يكن جيداً كما يجب بالتعامل مع ‫الشعوب الأجنبية ‫وخاصة إن اعتقد أنهم أقل منزلة ‫بالنسبة إلينا أو بالنسبة إلى أسلوب حياتنا.
His very high-handed treatment of the Colombians during the negotiations for the Panama treaty was inexcusable.	‫معاملته الاستبدادية للكولومبيين خلال ‫المفاوضات على اتفاقية "باناما" ‫لم يكن لها مبرر.
For Roosevelt, one great expansionist vision remained unfulfilled.	‫بالنسبة إلى "روزفلت" ‫تبقى حلم توسعي واحد لم يتحقق بعد.
For more than half a century, American and European investors had dreamed of a central American canal linking the Atlantic to the pacific.	‫لأكثر من نصف قرن كان المستثمرون ‫الأمريكيون والأوروبيون ‫يحلمون بقناة في "أمريكا الوسطى" ‫لتربط المحيط الأطلنطي بالمحيط الهادىء.
Roosevelt believed such an inter-ocean pathway was now indispensable for the full exercise of American naval power.	‫اعتقد "روزفلت" أن ممراً ‫بين المحيطات كهذا ‫لا غنى عنه لتطبيق القوة ‫البحرية الأمريكية الكاملة.
A French company was already trying to build a canal across the jungle-covered Panama province in the nation of Colombia, but that effort had stalled, a victim of poor planning, lack of money, and deadly tropical diseases.	‫بالفعل كانت تحاول شركة فرنسية بناء قناة ‫عبر "باناما" التي تغطيها الأدغال ‫في "كولومبيا" ‫لكن الجهود تعطلت
When the French offered to sell their rights, Roosevelt agreed to buy them, then instructed his secretary of state, John Hay, to negotiate a treaty with Colombia.	‫عندما قرر الفرنسيون بيع حقوقهم لها ‫قام "روزفلت" بالموافقة على شرائها ‫ثم أمر وزير خارجيته "جون هاي" ‫بالتفاوض على اتفاقية مع "كولومبيا".
It called for a payment of $10 million, plus an annual rental fee for a 6-mile "canal zone" across the isthmus.	‫تطلبت دفع 10 ملايين دولار ‫بالإضافة إلى أتعاب إيجار سنوية لمساحة ‫10 كم عبر البرزخ
But the Colombian senate rejected the deal, and then demanded double the price.	‫لكن مجلس الشيوخ الكولومبي ‫رفض الاتفاقية ثم طلب ضعف المبلغ.
Roosevelt was enraged.	‫غضب "روزفلت" كثيراً.
"I do not think that the bogota lot of Jack rabbits	‫قال "لا أعتقد أن المغفلين في (بوغوتا)
"should be allowed permanently to bar one of the future "highways of civilization, " he said.	‫يمكن السماح لهم بمنع أحد ‫أعظم الطرق في تاريخ الحضارات"
The refusal of the Colombian senate to honor its government's commitment was just the latest embodiment of the kind of "chaos" he deplored.	‫رفض مجلس الشيوخ الكولومبي الالتزام ‫بوعود حكومته كان آخر تجسيد ‫على نوع الفوضى التي كرهها.
Roosevelt believed that a canal across the central	‫اعتقد "روزفلت" أن قناة في منتصف ‫البرزخ الأمريكي
American isthmus would be good for the United States and good for civilization.	‫ستكون جيدة لـ"الولايات المتحدة" ‫وللحضارة بأكملها.
It would also be good for Theodore Roosevelt. He often mingled those three.	‫وستكون جيدة أيضاً لـ"ثيودور روزفلت" ‫فعادةً ما خلط بين ثلاثتهم.
And he believed that anybody, any government, any person who stood in the way of that was obstructing civilization.	‫وآمن أن أي حكومة أو شخص يعترض طريق هذا ‫فهو يعترض طريق الحضارة.
And Roosevelt had very little patience for those people who didn't see the way history was going, the way history is supposed to go in the same light that he did, and he simply wouldn't allow them to get in the way.	‫ولم يكن "روزفلت" صبوراً ‫مع مثل هؤلاء ‫ممن لم يروا التاريخ كما ‫يراه هو وكيف يجب أن يتطور. ‫ولم يكن يسمح لهم باعتراض طريقه.
He was determined to get an American canal underway.	‫كان قد قرر أن يبدأ ببناء ‫القناة الأمريكية
He would not attack Colombia directly, but he would exploit the aspirations of the people of Panama province, who had for 50 years asserted their wish to be independent of bogota.	‫لم يكن سيهاجم "كولومبيا" مباشرة ‫لكنه سيستغل طموحات سكان قطاع "باناما" ‫الذين أرادوا استقلالهم منذ 50 عاماً ‫عن "بوغوتا".
Roosevelt agreed to meet with Phillipe Bunau-Varilla, a lobbyist for the French canal-builders, who was in touch with rebels already eager to rise against	‫وافق "روزفلت" على لقاء ‫"فيليب بونو فاريا" ‫ممثل بنائي القناة الفرنسيين ‫والذي كان على تواصل مع الثوار ‫الذين يتوقون للنهوض ضد الحكم الكولومبي.
It was a delicate What did the frenchman think was going to happen in Panama province?	‫كان نقاشاً حساساً ‫ماذا كان يظن الفرنسي أنه ‫سيحدث في "باناما"؟
"Mr. President," his visitor said, "a revolution."	‫قال الزائر، "ثورة يا سيدي الرئيس".
Roosevelt was careful to say nothing about how the United States might respond.	‫كان "روزفلت" حريصاً بعدم ذكر شيء ‫عن كيفية رد "الولايات المتحدة".
His silence spoke volumes.	‫لكن صمته دل على الكثير.
He had no assurances in any way, but he is a very able fellow, and it was his business to find out what he thought our government would do.	‫لم يكن لديه تأكيد بأي طريقة ‫لكنه شخص قادر. ‫وكان من شأنه أن يعرف ‫ماذا ستفعل حكومتنا.
I have no doubt that he was able to make a very accurate guess and to advise his people accordingly.	‫لا أشك في أنه عرف تماماً ما كنا سنفعله ‫وأنه سينصح شعبه بناء على ذلك.
In fact, he would have been a very dull man had he been unable to make such a guess.	‫في الواقع، كان لابد أن يكون غبياً جداً ‫إن لم يتمكن من توقع الأمر.
5 days later, the rebels proclaimed their independence.	‫بعد خمسة أيام، أعلن الثوار استقلالهم.
An American cruiser landed troops to overcome the handful of Colombian soldiers the revolutionaries hadn't already bought off.	‫هبطت طوافة أمريكية بالجنود ‫للتغلب على المجموعة الصغيرة ‫من الجنود الكولومبيين ‫الذين لم يرشوهم الثوار بعد.
It was all over within 72 hours.	‫انتهى كل شيء خلال 72 ساعة.
The President was presiding at a cabinet meeting at 11:35 on the morning of November 6, 1903, when a messenger brought him the happy news.	‫كان الرئيس يترأس جلسة مجلس ‫الساعة 11 و30 دقيقة، صباح 6 نوفمبر 1903 ‫عندما أبلغه مراسل ‫بالنبأ السعيد.
By the time lunch was served, the United States had recognized the brand-new Republic of Panama.	‫بوقت تقديم الغداء، ‫كانت "الولايات المتحدة" ‫تعترف بجمهورية "باناما" الحديثة.
"The people of the isthmus, " Roosevelt would claim, "rose literally as one man."	‫قال "روزفلت"، ‫"شعب البرزخ نهضوا كرجل واحد".
"Yes, " said a senate critic, "and that man was Roosevelt."	‫قال ناقد مجلس الشيوخ ‫"أجل، وذلك الرجل هو (روزفلت)."
Work on the great canal began again, but now it was an American project.	‫بدأ العمل على القناة العظيمة مجدداً ‫لكنها أصبحت مشروعاً أمريكياً الآن
And Roosevelt himself would not be able to resist seeing it for himself, the first President ever to leave the country while in office.	‫ولم يقاوم "روزفلت" الذهاب ‫لرؤيتها بنفسه ‫أول رئيس يغادر البلاد ‫وهو في منصبه.
The Panama canal is one of the great achievements of the human race.	‫إن قناة "باناما" أحد أعظم الإنجازات ‫للعرق البشري.
I mean just a stupendous achievement, wonderfully conceived, brilliantly executed, with all kinds of ancillary benefits...	‫أعني أنه إنجاز مذهل ‫وفكرته مهولة ‫ونفذ بعبقرية مع جميع أنواع الفوائد ‫الإضافية كهزيمة الأمراض وأشياء أخرى.
And it's the sort of thing that America did just to affirm its greatness.	‫وهو شيء فعلته "أمريكا" ‫من أجل تأكيد عظمتها.
It's better to do it that way than conquering other people.	‫وفعلها بهذه الطريقة ‫أفضل من غزو الآخرين
This was a wholly beneficial addition.	‫وهذا بحد ذاته فائدة إضافية.
Now we did get the land for the Panama canal by a not-too-salubrious deal with certain central American countries.	‫لقد حصلنا على الأرض لقناة "باناما" ‫بطريقة ليست ناجعة جداً ‫بالنسبة لبعض دول "أمريكا الوسطى".
But as was said at the time of the Panama canal treaty, "we stole it fair and square."	‫لكنه كما قيل وقت معاهدة قناة "باناما" ‫"لقد سرقناها بالعدل."
I took the canal zone and let congress debate, and while the debate goes on, the canal does, too.	‫"مسار القناة" ‫أنا أخذت منطقة القناة وتركت الكونغرس ‫يتناظر بالأمر، ‫وبهذه الأثناء استمر الجدل ‫وكذلك العمل على القناة.
And now instead of discussing the canal before it was built, which would have been harmful, they merely discuss me...	‫وبدلاً من مناقشة القناة قبل البدء ببنائها ‫وكان سيصبح أمراً ضاراً، ‫فهم يناقشون أمري فقط
A discussion which I regard with benign interest.	‫وهو نقاش أقدره كثيراً.
For Thanksgiving that year, Franklin Roosevelt and his mother traveled to the delano family homestead at Fairhaven, Massachusetts, rather than face the prospect of being at Springwood without his father, Mr. James.	‫في عيد الشكر ذلك العام ذهب ‫"فرانكلين روزفلت" ووالدته ‫إلى منزل عائلة "ديلانو" ‫في "فايرهايفن"، "ماساتشوستس" ‫بدلاً من مواجهة التواجد في "سبرينغوود" ‫دون والده السيد "جايمس".
After dinner, Franklin took Sara for a walk in the garden.	‫بعد العشاء أخذ "فرانكلين" "سارة" ‫لتمشي في الحديقة.
He had something to tell her.	‫كان لديه ما يخبرها به.
He had fallen in love with his fifth cousin, Eleanor Roosevelt, the orphaned daughter of the President's late brother, Elliot.	‫فقد وقع في الحب مع ابنة عمه ‫الخامسة "إلينور روزفلت" ‫اليتيمة ابنة أخي الرئيس ‫المتوفى "إليوت"
He had asked her to marry him.	‫وطلب منها الزواج به.
She had said yes.	‫وقد وافقت.
Sara was stunned.	‫صعقت "سارة".
Franklin was just 21; Eleanor only 19.	‫كانا يافعين برأيها، "فرانكلين" عمره ‫21 عاماً و"إلينور" عمرها 19 عاماً
And if they married, she feared she would be left alone.	‫وإن تزوجا، ‫فقد كانت تخشى أن تترك وحدها.
Franklin did his best to reassure her.	‫فعل "فرانكلين" ما بوسعه لطمأنتها.
"You know, dear mummy, that nothing can ever change "what we have always been and always will be to each other, " he wrote.	‫"تعلمين يا أمي العزيزة أن لا شيء سيتغير ‫ما بيننا سيكون كذلك إلى الأبد."
"Only now you have two children to love and to love you."	‫"ولكن لديك طفلين الآن ‫لتحبيهما وليحباك."
It is impossible for me to tell you how I feel toward Franklin.	‫يستحيل لي أن أخبرك ‫بما أشعر به تجاه "فرانكلين".
