Previously on "The Blacklist"...	Anteriormente en "The Blacklist"...
- You want to call your daddy?	- ¿Quieres llamar a tu papá?
- Yeah, I want to tell him I'm okay.	- Sí, quiero decirle que estoy bien.
Okay.	Bien.
Lizzy... Be careful of your husband.	Lizzy... ten cuidado con tu esposo.
I can only lead you to the truth.	Solo te puedo dirigir a la verdad.
I can't make you believe it.	No puedo hacer que la creas.
She's calling herself Jolene Parker.	Se hace llamar así misma Jolene Parker.
Elizabeth Keen is not your wife, she's your target.	Elizabeth Keen no es tu esposa, es tu objetivo.
You have been threatening to tell me the truth about my husband since the day we met, and I'm ready to listen.	Has estado amenazándome con contarme la verdad acerca de mi esposo desde el día en que nos conocimos y estoy lista para oírla.
Right now, the only thing that matters is the immediate threat... Your husband...	Ahora mismo, lo único que importa es la amenaza inmediata... tu esposo.
Finding out who he is and who he works for.	Descubriendo quién es y para quién trabaja.
The rest will come.	Lo demás vendrá.
I promise you.	Lo prometo.
	¿Qué sucedió?
	¿Qué ocurre? ¡Aléjate de ella! - ¿Qué sucedió?
-	¡Vamos!
Asset on board. En route.	Activo a bordo, en camino.
12 cc epinephrine.	12 cc de epinefrina.
Clear.	Despejen.
	¡Vamos, vamos!
- 45 seconds.	¡De prisa! 45 segundos.
-	Por favor, váyase. - ¿Qué pasa? - Alto.
	Mira, ¿qué es eso?
-	¿Qué está buscando? Sí. ¡Fuera!
	¡Fuera!
We need more adrenaline.	Necesitamos más adrenalina.
Cover her mouth.	Cubre su boca.
It's okay.	Está bien.
It's okay.	Está bien.
It's okay.	Está bien.
Shh! It's okay.	Está bien.
You're okay.	Estás bien.
You're okay.	Estás bien.
Rest.	Descansa.
You'll be in America by morning.	Estarás en América por la mañana.
We're taking you to Washington, D.C.	Te estamos llevando a Washington, D.C.
Do you know where the prisoner was transported to?	¿Sabes a dónde fue transportado el prisionero?
Uh, Washington.	Washington. Bien.
Okay. Yes, we'll take care of it.	Sí, nos haremos cargo de ello.
Very good.	Muy bien.
-	Hezbollah... tendrán que esperar. Volvemos a Washington.
Washington?	¿Washington?
Since when did Jolene Parker's case go from missing person to murder investigation?	¿Desde cuándo el caso de Jolene Parker pasó de ser una persona desaparecida a una investigación de homicidio?
- And have you seen my keys?	- ¿Has visto mis llaves?
- It's crazy, right?	- Es una locura, ¿cierto?
Yeah, what, uh... What happened?	Sí... ¿qué pasó?
The police say they have a person of interest.	La policía dice que tienen a un sospechoso.
Really?	¿En serio?
Who is it?	¿Quién es?
What do they...	¿Qué...?
What do they know?	¿Qué saben?
They're not sure.	No están seguros.
Isn't it possible that she just left town like she said?	¿No es posible que solo haya abandonado la ciudad, como dijo ella?
Moved to Dayton?	¿Se mudó a Dayton?
They found blood...	Encontraron sangre.
Matches hers.	Concuerda con la de ella.
You see this stuff every day...	Ves diariamente estas cosas...
You know, people getting hurt and killed... and... I don't.	Gente siendo herida y asesinada... y... no lo sé.
It freaks me out.	Me vuelve loco.
Just the thought of that happening to you, you know...	El solo pensar que te suceda algo, ya sabes...
Just promise me you're as careful as you can be when you're at work.	Solo prométeme que serás muy cuidadosa cuando estés en el tabajo.
- The desk. - Hmm?	En el escritorio.
By the computer...	Por el computador.
That's where I saw your keys.	Ahí es donde vi tus llaves.
Oh. I'm gonna be so late.	¡Voy a llegar muy tarde!
I'm gonna give myself a tardy slip.	Voy a ponerme una nota de tardanza.
Found 'em!	¡Las encontré!
They were under the newspaper.	Estaban bajo el periódico.
What would I do without you?	¿Qué haría sin ti?
I got to run.	Tengo que irme.
Uh, tonight for dinner, let's check out that new thai place.	Esta noche para la cena, vamos a echar un vistazo a ese nuevo lugar tailandés.
He knows something's off.	Él sabe que hay algo que no está bien.
What makes you say that?	¿Por qué lo dices?
I can feel it.	Lo puedo sentir.
I know him.	Lo conozco.
Tom is on his heels.	Tom está sobre sus talones.
He's behaving erratically.	Se comporta de forma errática.
He killed Jolene Parker.	Mató a Jolene Parker.
Yes.	Sí.
You knew?	¿Lo sabías?
Why didn't you tell me?	¿Por qué no me lo dijiste?
I felt if I told you it would inform your behavior with him.	Pensé que si te decía, cambiaría tu comportamiento con él.
I found her body, called the police, and reported a missing person.	Encontré su cuerpo, llamé a la policía y la reporté como desaparecida.
I was confident, in the course of their investigation, they would reach out to you and Tom, and they did.	Confiaba que durante la investigación hablarían con Tom y contigo, y lo hicieron.
Jolene Parker undoubtedly worked for the same organization as Tom...	Jolene Parker indudablemente trabajaba para la misma organización que Tom...
In what capacity, I have no idea.	En calidad de qué, no tengo ni idea.
If they worked together, why would he murder her?	Si trabajaban juntos, ¿por qué la asesinó?
Perhaps he was ordered to.	Probablemente se lo ordenaron.
Or perhaps he's just...	O probablemente solo está...
Out of control, irrational...	fuera de control, irracional...
Paranoid and reactionary.	Paranoico y reaccionando.
He's scrambling for a foothold, and therein lies our opportunity to wait and to watch.	Él está luchando por obtener un punto de apoyo y ahí radica nuestra oportunidad para esperar y ver.
But Tom is not the reason I'm here.	Pero Tom no es la razón por la que estoy aquí.
I'm afraid there's something quite timely afoot.	Me temo que no hay algo muy puntual en marcha.
The Pavlovich brothers are back in town.	Los hermanos Pavlovich están de regreso.
You're talking about the team from the bridge that grabbed the general's daughter.	Estamos hablando del grupo en el puente que secuestró a la hija del general.
They're an extraction team... Cut their teeth on Milosevic's protective detail during the ethnic cleansing of the Yugoslav wars.	Son un equipo de extracción... estrenaron con los detalles de protección de Milosevic durante la limpieza étnica de la guerra yugoslava.
We lost six of our men that day.	Perdimos seis hombres ese día.
To the best of our knowledge, the Pavlovich brothers have no political agenda.	Lo que mejor sabemos es que los hermanos Pavlovich no tienen agenda política.
They specialize in snatch-and-grabs ranging from kidnap and ransom to extracting political dissidents.	Se especializan en la mecánica del juego desde secuestro y rescate hasta extraer disidentes políticos.
Reddington says he has a contact.	Reddington dice que tiene un contacto.
A money launderer sourced by the brothers claims they're coming after a Chinese scientist named Xiaoping Li.	Un lavador de dinero procedente de los hermanos dice que persiguen a una científica china llamada Xiaoping Li.
- What do we know about her?	- ¿Qué sabemos de ella?
- 18 hours ago, the agency sent an undercover team to extract her from a clandestine labor camp in the Yunnan province.	- Hace 18 horas la agencia envió un grupo encubierto para extraerla de un campo de trabajo forzado en la provincia de Yunnan.
- Break her out?	- ¿Rescatarla?
Why?	¿Por qué?
- She's an immunologist...	- Es una inmumonóloga...
Specializes in viral and bacterial diseases.	Se especializa en enfermedades virales y bacterianas.
Four months ago, she signaled to one of our assets that she had a willingness to talk about a secret weapons program.	Hace cuatro meses le señaló a uno de nuestros activos que estaba dispuesta a hablar sobre un programa secreto de armas.
A month later, she was jailed for treason.	Un mes después fue encarcelada por traición.
She's scheduled to land at Andrews in an under an hour, and we have a team standing by to escort her to Langley	Está programado para que aterrice en una hora, y tenemos un grupo esperándola para escoltarla a Langley
- for a debriefing.	- para interrogarla.
- We got to assume that the Pavlovich brothers already know the route.	- Tenemos que asumir que los hermanos Pavlovich ya conocen la ruta.
Well, then we'll reroute her.	Bueno, le cambiaremos la ruta nuevamente.
Bring her here.	Tráiganla acá.
Coordinate the adjustment with Langley.	Coordinen el ajuste con Langley.
Echo to tango.	Eco a Tango.
Uh, asset at drop point.	Activo en punto de entrega.
Roger. 30 seconds to rendezvous.	Entendido. Treinta segundos para el encuentro.
- This way.	- Por aquí.
Quickly.	Rápido.
- What's going on?	- ¿Qué sucede?
They said I'd be safe once I arrived.	Dijeron que estaría a salvo una vez que aterrizara.
We have a credible threat you're being targeted.	Tenemos una amenaza contra su vida.
As a precaution, we've altered our route.	Como precaución, cambiamos la ruta.
Get her up to the chopper.	Súbela al helicóptero.
Donald Ressler.	Donald Ressler.
FBI.	FBI.
Where's the asset?	¿Dónde está el activo?
- Ground transport's been arranged.	- Transporte por tierra ha sido arreglado.
- Negative.	- Negativo.
Evac's been compromised.	La evacuación ha sido comprometida.
Moving to beta proto...	Moviendo a protocolo beta...
Call it in.	Repórtalo.
All right.	está bien.
Okay.	De acuerdo.
Copy that.	Entendido.
Anne Arundel county sheriff's department's reporting a downed aircraft burning two miles outside of Crofton.	Anne Arundel del departamento del sheriff del condado reportando una nave derribada incendiándose a tres kilómetros en las afueras de Crofton.
There's no witnesses on the ground.	No hay testigos en el lugar.
We do have units en route.	Tenemos unidades en camino.
It's got to be the dump site	Debe ser el lugar de aterrizaje
- on this chopper.	- de este helicóptero.
- They knew CIA protocol...	- Conocían el protocolo de la CIA...
That if the routes were compromised, they'd send in air support.	Si las rutas estaban comprometidas, enviarían apoyo aéreo.
These guys weren't based domestically.	Estos tipos no son comunes.
They snuck in, and they're gonna sneak out.	Ellos se infiltraron, y se van a escapar.
We should coordinate with homeland, get their faces everywhere.	Deberíamos coordinar con seguridad nacional, poner sus caras en todos lados
Agent Malik, you want to tell me why the director of national intelligence is calling?	Agente Malik, ¿quiere decirme por qué está llamando el director de Inteligencia Nacional?
What don't I know about this case?	¿Qué es lo que no sé sobre este caso?
The program li was working on... It's germ weaponry...	El programa en el que Li estaba trabajando era armamento biológico.
Banned by nearly every nation on Earth.	Prohibido por casi todas las naciones de la Tierra.
It's called Whitefog.	Se llama Niebla Blanca.
Day before she was jailed, Xiaoping Li sent a message indicating that she had access to the designs.	El día antes de su encarcelamiento, Xiaoping Li envió un mensaje indicando que tenía acceso a los diseños.
If she did, and she shared those with us, that would represent the biggest intelligence coup in a decade.	Si los tenía y los hubiera compartido con nosotros, eso significaría el mayor golpe de inteligencia de la década.
A germ-warfare program?	¿Un programa de armamento biológico?
That's why the Chinese can't turn this into an international incident.	Es por esto que los chinos no pueden convertir esto en un incidente internacional.
- Where are you?	- ¿Dónde estás?
- Busy.	- Estoy ocupada.
The brothers... They took Xiaoping Li.	Los hermanos... se llevaron a Xiaoping Li.
How do you know?	¿Cómo lo sabes?
Do you have a lead?	¿Tienes alguna pista?
Something we can...	Algo que podamos...
- Your husband is not in school.	- Tu esposo no está en la escuela.
- Wait. What?	- Espera. ¿Qué?
Where is he?	¿Dónde está?
Meet me at 9th and Constitution.	Veme en la Novena y Constitución.
Reddington says he has a lead on the brothers.	Reddington dice que tiene un pista de los hermanos.
Wants to talk.	Quiere hablar.
Let me know what NTSB says about that downed aircraft.	Hazme saber que dice NTBS acerca de la nave caída.
Called in sick this morning.	Faltó por enfermedad esta mañana.
Returned home briefly before making a stop at the Radford Bank in Adams Morgan.	Volvió a casa brevemente antes de hacer una parada en el banco Radford en Adams Morgan.
He's made three phone calls...	Ha hecho tres llamadas...
All from pay phones.	Todas de teléfonos prepagos.
He's been sitting at that cart for nearly an hour.	Ha estado sentado en ese auto por casi una hora.
I'm sorry, Lizzy.	Lo siento, Lizzy.
Don't be.	No lo sientas.
This must be difficult.	Esto debe ser difícil.
You want to know what's hard?	¿Quieres saber qué es duro?
Sitting here when all I really want to do is get my hands around his throat.	Quedarme sentada aquí cuando todo lo que quiero hacer es poner mis manos en su garganta.
- Shouldn't we follow him?	- ¿No deberíamos seguirlo?
- We are.	- Lo estamos haciendo.
They all work for you.	Todos ellos trabajan para ti.
Lizzy, wait, wait, wait.	Lizzie, espera, espera, espera.
What are you do...	¿Qué estás ha...?
Not now.	Ahora no.
The boat...	¿El bote?
How long for the boat?	¿Cuánto falta para el bote?
No.	No.
No.	No.
Please, no.	Por favor, no.
Tom?	¿Tom?
Tom?	¿Tom?
I'm in the dining room.	Estoy en el comedor.
Where'd you get that thing?	¿Dónde conseguiste eso?
I was gonna ask you the same question.	Te iba a hacer la misma pregunta.
I found it in the basement.	Lo encontré en el sótano.
That's where that was.	Ahí era que estaba.
I've been looking for it.	Lo estaba buscando.
My father gave it to me.	Mi padre me lo dio.
It's beautiful.	Es precioso.
It's in great condition, too.	Está en muy buenas condiciones.
It looks almost new.	Parece casi nuevo.
Why haven't I seen this before?	¿Por que no lo he visto antes?
Your pot is gonna boil over.	Tu olla va a hervir.
You're cooking?	¿Estás cocinando?
I thought we were going out for thai.	Creí que ibamos a salir por comida thai.
Yeah, well, I just thought it might be nice, you know, to stay home alone... Just you and me.	Es solo que pensé que sería lindo, ya sabes, quedarnos en casa solos... solo tú y yo.
How was your day?	¿Cómo estuvo tu día?
It was exhausting.	Estuvo cansado.
You know Billy Salter?	¿Conoces a Billy Salter?
He was acting up again 'cause his mom keeps packing these fruit roll-ups, and they give him this satanic sugar high, you know.	Estuvo actuando nuevamente porque su madre sigue poniéndole estos rollos de fruta, y le dan esta excitación satánica de azúcar, ya sabes.
So...	Así que...
Oh, uh, I did stop by the national archives just to maybe book a field trip for the kids.	Me detuve en archivos nacionales solo para tal vez reservar un día de campo para los niños.
It's funny.	Es gracioso.
I, uh... I could have sworn that I saw you there.	Yo... podría haber jurado que te vi ahí.
There was a woman there, and she looked just like you.	Había una mujer allí, y se parecía a ti.
Ah, no, I wish.	No, ojalá.
I was cooped up in the office all day.	Estuve todo el día encerrada en la oficina.
Yeah.	Sí.
Should have known.	Debería haberlo sabido.
Well, whoever she was, she could not have been half as beautiful as you are right now.	Bueno, quienquiera que fuera, ella no podría haber sido la mitad de lo hermosa que estás en este momento.
All right.	Bien.
Uh, keep stirring.	Sigue revolviendo.
I'm gonna walk the dog.	Voy a sacar a pasear al perro.
Come on, bud. Hey, hey, hey.	Vamos, amigo.
Come here.	Ven aquí.
Hey, hey, hey. Where you going?	Oye, oye, oye. ¿A dónde vas?
Come here.	Ven acá.
Come here.	Ven acá.
Yes, you're a good boy.	Eres un buen chico.
Yes, you are.	Sí, lo eres.
Yes, you are.	Sí, lo eres.
What?	¿Qué?
Nothing.	Nada.
Love you.	Te amo.
- I'll be right back.	- Ya regreso.
Come on, bud.	Vamos, amigo.
- Come on.	- Vamos.
Come on.	Vamos.
Such a good boy.	Eres un muy buen chico.
You're a good boy.	Eres un buen chico.
Yes, yes, yes.	Sí, sí, sí.
Bantam finance.	Finanzas Bantam.
How may I direct your call?	¿A dónde transfiero su llamada?
Hi.	Hola.
I'm having a problem with my account.	Tengo un problema con mi cuenta.
Uh, number Delta, Sierra, 4-5-1.	Número DS451.
Line is secure.	La línea es segura.
Proceed.	Proceda.
Mockingbird knows.	Ruiseñor lo sabe.
Requesting immediate evac.	Solicito evacuación inmediata.
She knows.	Ella lo sabe.
He's gone.	Él se fue.
My husband is gone.	Mi esposo se fue.
Your husband never existed.	Tu esposo nunca existió.
Lizzy, I understand why you went after Tom today.	Lizzy entiendo por qué fuistes tras Tom hoy.
The instinct to jump in is... But it isn't gonna serve you well here.	El instinto de arriesgarse es... pero no te va a servir aquí.
And from the emotional point of view, this must feel like an extraordinary violation and betrayal.	Y desde el punto de vista emocional esto debe sentirse como una traición y violación extraordinaria.
But for Tom it was business.	Pero para Tom solo fueron negocios.
Do you know we had sex the other night?	¿Sabes que tuvimos sexo la otra noche?
Do you have any idea how filthy that makes me feel?	¿Tienes alguna idea de lo sucia que me hace sentir eso?
Unfortunately, Lizzy, you're chest-deep in filth, and you're gonna have to wade through it	Desafortunadamente, Lizzy, estás metida hasta el pecho de suciedad y vas a tener que atravesarlo dificultosamente
- to get to the other side.	- para llegar al otro lado.
- I fell in love with him.	- Me enamoré de él.
I married him.	Me casé con él.
We... we were gonna have...	Nosotros íbamos a tener...
I was excited to have a child with him.	Estaba emocionada con tener un hijo con él.
He was the one person I chose in my life who made me happy, who made me feel safe.	Él fue la única persona que escogí en mi vida que me hizo feliz, que me hizo sentir segura.
What does that say about me?	¿Qué es lo que dice de mí?
Everything that we had was just a figment of my imagination...	Todo lo que teníamos era solo una ilusión...
Worse than a figment... A lie.	Peor que una ilusión... una mentira.
It was right in front of my face, and I didn't see it.	Estuvo frente a mi cara, y no lo vi.
I just... believed it.	Yo solo... lo creí.
All of it.	Todo.
Time is the only thing that will allow you to find yourself again.	El tiempo es la única cosa que te permitirá encontrarte contigo misma otra vez.
If you tell me to be patient one more time, I swear to God...	Si me dices que sea paciente una vez más, te juro por Dios...
I am going to find him, I'm gonna find answers, and I'm going to do it with or without your help.	Lo voy a encontrar, voy a encontrar respuestas, y lo voy a hacer con o sin tu ayuda.
The case.	El caso.
I need a lead.	Necesito una pista.
Lizzy, if you want to find where the Pavlovich brothers are, you need to find out where they've been.	Lizzy, si quieres encontrar donde están los hermanos Pavlovich, necesitas descubrir donde han estado.
The helicopter is key.	El helicóptero es la clave.
The Pavlovich brothers burnt that chopper to cover up evidence...	Los hermanos Pavlovich quemaron ese helicóptero para cubrir evidencia...
DNA, fingerprints.	ADN, huellas.
Those things might have identified the brothers, but what about the chopper?	Esas cosas podrían haber identificado a los hermanos, ¿pero qué hay del helicóptero?
The tail numbers were falsified, and the chopper was repainted.	Los números de la cola fueron falsificados y el helicóptero fue repintado.
That's what they did, but where did they do it?	Eso fue lo que hicieron, ¿pero dónde?
Is there a deeper forensic analysis we can run?	¿Hay algún análisis forense más detallado que podamos hacer?
What particulates were in the heat exchange?	¿Qué partículas había en el intercambio de calor?
Was there moisture in the compressor?	¿Había humedad en el compresor?
I'll reach out to forensics.	Investigaré con los forenses.
Analyze every drop of fuel.	Analiza cada gota de gasolina.
Track every grain of sand.	Sigue cada grano de arena.
I want to know where that chopper's been.	Quiero saber dónde ha estado ese helicóptero.
That's him.	Es el suyo.
I'm sorry, man.	Lo siento, viejo.
Not for hire.	No estoy para contratar.
Hello, Symir.	Hola Symir.
I'll be brief and to the point.	Seré breve e iré directo al grano.
Yesterday you had a customer... Picked him up outside the national archives.	Ayer tuviste un cliente... lo recogiste fuera de los archivos nacionales.
Sorry, man.	Lo siento, viejo.
Ohh, Symir.	Oh, Symir.
You should have taken the money.	Deberías haber agarrado el dinero.
Your passenger... Where'd you drop him?	Tu pasajero... ¿dónde lo dejaste?
Calculus.	Cálculo.
I can't even think about derivatives without thinking of that tutor in manor hall...	Ni siquiera puedo pensar en derivados sin recordar a esa tutora en Manor Hall...
Cindy something-or-other.	Cindy o algo así.
Never wore a brassiere;	Nunca usó un sostén.
Always a bounce in her step.	Siempre un rebote en sus pasos.
Look, I'm talking, cooperating.	Mira, estoy hablando, cooperando.
You don't need to copy my driver's license, my credit cards.	No necesitas copiar mi licencia de conducir, o mis tarjetas de crédito.
We just want to make sure we know where to reach you,	Solo queremos asegurarnos de saber donde localizarte,
Geoffrey P. Seevers, should we have more questions.	Geoffrey P. Seevers, deberíamos tener más preguntas.
So, tell me about the book.	Entonces dime acerca del libro.
I told you... I pick up and drop off.	Se los dije... solo lo recogí y lo dejé.
I don't know names.	No sé nombres.
I'm the messenger.	Solo soy el mensajero.
What is it?	¿Qué es?
Some kind of code?	¿Alguna clase de código?
How many times have you done this... these drops?	¿Cuántas veces has hecho estos encargos?
This was the fourth.	Este fue el cuarto.
I need you to write down the location of each drop you've made...	Necesito que escribas el lugar de cada entrega que has hecho...
The pickup and the drop location.	El lugar de recepción y de entrega.
Oh, my God. What?	Oh, Dios mío. ¿Qué?
Pagosa Springs public library?	¿La biblioteca pública de Pagosa Springs?
I had a water pump go out in Pagosa Springs.	Tuve una falla con la bomba de agua en Pagosa Springs.
Bitch of a mountain...	Una montaña desgraciada...
Wolf Creek Pass.	Wolf Creek Pass.
Thought I was gonna end up living out there with the hill people until this Teddy bear of a man fixed me up at the local garage.	Creí que iba a terminar viviendo con la gente de la montaña hasta que este oso Teddy de hombre me la arregló en el garage local
I'll never forget him.	Nunca lo olvidaré.
Tracy Woods.	Tracy Woods
You don't know Tracy, do you?	¿No conoces a Tracy, no?
Leather vest, mustache... Tracy Woods?	Chaleco de cuero, bigote ¿Tracy Woods?
No.	No
I wonder if he's still fixing water pumps.	Me pregunto si sigue arreglando bombas de agua.
Anyway, it'll always be a fond memory.	Como sea, siempre sera un lindo recuerdo.
The list.	La lista.
S-so, that's it?	Y, ¿es todo?
We're...	, Estamos...
What about the package?	¿Que hay del paquete?
You're gonna deliver it or return it or whatever the people you work for want you to do with it.	Vas a entragarlo o devolverlo o lo que sea que quiera la gente para la que trabajas que hagas.
And as far as you're concerned, we never had this conversation.	Y en lo que a ti concierne, nosotros nunca tuvimos esta conversación.
Dembe?	¿Demde?
A copy, please.	una copia, por favor.
I hope you have nothing pressing.	Espero que no tengas nada urgente.
This may take a minute or three.	Esto tomara un minuto o tres
You sure you don't know him?	¿Seguro que no le conocías?
Leather vest, mustache... Tracy Woods?	Chaleco de cuero, bigote ¿Tracy Woods?
Shame.	Vergüenza.
Hey.	Oye
I got something.	Tengo algo.
Hey. Okay, I never wanted to know this much about gas chromatography or gear lubricants, but I think Mr. Reddington is onto something.	Esta bien nunca quise saber tanto acerca cromatografía de gases o lubricante para tuercas pero creo que el señor Reddington esta tras algo.
Look at this.	Mira esto.
We pulled the lab reports from the NTSB, and the chopper's engine tested positive for two distinct compounds.	Conseguimos los resultados del laboratorio de NTSB, y el examen del motor del helicóptero salió positivo para dos compuestos distintos
The first is ethephon, which is a ripening agent for tobacco.	El primero es ethepon, que es un agente de crecimiento para el tabaco.
- And how does that help us?	¿Y cómo nos ayuda eso?
- Take a look.	Mira.
Tobacco production's way down in this area.	La producción de tabaco es muy baja en esta area.
In fact, since 1998, the federal government is actually paying farmers not to grow it.	De hecho, desde 1998, el gobierno federal ha estado pagando a los granjeros para que no lo cultiven.
Okay, but there's still plenty of tobacco farms.	Bueno, pero todavía hay un montón de granjas de tabaco.
I agree, which brings us to chemical compound number two.	Estoy de acuerdo, lo que nos lleva al compuesto número dos.
This one is used to grow sweet corn.	Este es usado para cultivar maiz.
So we cross-reference the two?	¿Entonces relacionamos los dos?
Exactly.	Exacto.
We are looking for a pesticide manufacturer who used to supply tobacco growers but made the transition to corn.	Estamos buscando a un productor de pesticidas Que solía abastecer a cultivadores de tabaco pero que hizo la transición a maíz.
And how many of those are there?	¿Y cuantos de esos hay?
17. Wait.	17 Espera.
Of those, 11 are outside of the fuel range of this chopper.	De esos, 11 estan fuera del rango de combustible de este helicóptero
Uh, of the other six, uh, only one has a structure large enough to get that stolen helicopter out of view and under construction.	De los otros seis, Solo uno tiene una estructura lo suficientemente larga para conseguir ese helicóptero robado fuera de vista y bajo construcción.
Halifax Agro-Chem.	Halifax Agro-Chem
If I had to bet, I'd say that's their staging site.	Si tuviera que apostar diría que ese es su lugar de planeamiento.
It's around the corner, half a block up. I make seven exterior cameras, and those are the ones they want us to see.	Está a la vuelta de la esquina, medio bolque arriba y esas son las que quieren que veamos.
And it's on the list of drop sites I gave you?	¿Y está en la lista de los lugares de bajadas que te di?
Yes.	Si.
How long has Mr. Keen been inside?	¿Cuánto tiempo ha estado adentro el Sr. Keen?
I tailed him here four hours ago.	Lo seguí aquí hace cuatro horas.
Lovely.	Encantador.
Thank you, Preston.	Gracias, Preston.
- You want me to call Sabusawa?	-¿Quieres que llame a Sabusawa?
- That would be ideal, but he's working an extraction in Ecuador.	-Eso seria ideal pero está trabajando en una extracción en Ecuador.
Then how do you plan on getting keen out of that concrete box?	¿Entonces como planeas sacar a Keen de esa caja de concreto?
- We have a lead on Xiaoping Li.	-Tenemos informacion de Xiaoping Li
- Excellent.	-Exelente
- Tell me.	-Dime
- We think she's being held at Halifax Agro-Chem in Falls Church.	-Creemos que esta detenido en Halifaz Agro-Chem en Falls Church.
We're assembling a team.	Estamos montando un equipo
Lizzy, about Tom...	Lizzy, acerca de Tom...
I don't want to talk about Tom with you.	No quiero hablar de Tom contigo.
You have your opinion on how to proceed, and I have mine.	Tu tienes tu opinión en como proceder, y yo tengo la mía.
Just don't bother yourself. I'll deal with Tom.	Solo no te molestes a ti misma Yo me encargare de Tom.
Lizzy, I assure you that will yield no answers and little satisfaction.	Lizzy, te aseguro que eso producirá ninguna respuesta y poca satisfacción.
Well, I'll find out, won't I?	¿Bueno, ya lo descubriré, no?
I wish I could talk you out of this.	Desearía poder convencerte fuera de esto
You can't.	No puedes
Well, good luck with Xiaoping...	Bien, suerte con Xiaoping...
Good afternoon, gentlemen.	Caballero, buenas tardes.
I'm Raymond Reddington.	Soy Raymond Reddington.
Hey. Look at this.	Oye, mira esto.
What are we looking at?	¿Que estamos viendo?
I have no idea.	No tengo idea.
Hey!	¡Oye!
Get out of here!	¡Lárgate de aquí!
Go!  What the hell was that?	¡Ve! ¿Que demonios fue eso?
Out!	¡Afuera!
Out!	¡Afuera!
Move!	¡Muévanse!
Move!	¡Muévanse!
Move!	¡Muévanse!
Fall back. Asset en route.	Retrocedan Activo en ruta.
We're moving to the cars.	Nos movemos a los autos.
- - -	Quiero decir, parece algún tipo de número serial.
Or an atomic number...	O un número atómico...
Something from a periodic table.	Algo de la tabla periódica.
Why do you think that?	¿Por qué piensas eso?
Because the only word I know that contains the letters "v-g" together is avgolemono.	Porque la única palabra que conozco que contiene las letras "v-g" juntas es el "avgolemono".
I don't know what that is.	No sé que es eso.
It's a soup.	Es una sopa.
Chicken stock, egg yolks, and lemon juice.	Caldo de pollo, yema de huevo, y jugo de limón.
What?	¿Qué?
I cook.	Yo cocino.
The point is, maybe Xiaoping Li left us a message.	El punto es, quizás Xiaoping Li nos mandó un mensaje.
I'll run the letter combination against the DMV registry	Buscaré la combinación de letras en el registro DMV
- and see if we can get a hit.	- y veamos si acertamos.
- Any luck?	- ¿Algo de suerte?
- I can't get ahold of Reddington.	-No puede ponerme en contacto con Reddington -¿Le dijistes la ubicación donde
- You told him the location where the brothers were holding Xiaoping Li, right?	Los hermanos tenían a Xiaoping Li, cierto?
- Mm-hmm. - Don't you find it a hell of a coincidence that we show up there, they're gone, and now we can't get ahold of Reddington?	-No lo encuentras una gran coincidencia que aparecemos aquí, ellos no estan y ahora no podemos ponernos en contacto con Reddington.
- We've been played.	-Nos ha engañado
- No.	-No
Red put us on to the Pavlovich brothers because he knew it would lead him straight to Xiaoping Li.	Red nos informó de los hermanos Pavlovich porque sabía que lo llevría derecho hacia Xiaoping Li.
That woman's worth millions.	Esa mujer vale millones
Where are you going?	¿A donde vas?
I'm going to find Reddington, get some answers.	Voy a encontrar a Reddington, a conseguir algunas respuestas.
Reddington, I need you to call me, please.	Reddington, necesito que me llames, por favor.
I need some help with the case.	Necesito ayuda con el caso.
A gift from Reddington.	Un regalo de Reddington.
Enjoy.	Disfrútalo.
Two years wasted.	Dos años perdidos.
Two years we spent. On what?	Dos años que gastamos. ¿En que?
Do you care at all what you've done to me...	Te importa en lo mas minimo lo que me has hecho...
What you've done to my life?	Lo que le has hecho a mi vida
What has it done to you?	¿Que se te ha hecho a ti?
Who could do such a thing?	¿Quien podria hacer algo asi?
Finding you, stopping you...	Encontrandote, Deteniendote..
You'd think I'd be happy you're gonna spend the rest of your life in prison.	Creerías que estaría Feliz Vas a pasar el resto de tu vida en prisión
You'd think I'd get some satisfaction out of that, but I don't because nothing...	Creerías que tendría alguna satisfacción de esto Pero no la tengo, porque nada..
No sentence, no punishment, no revenge, could ever come close to making up for what you've done.	Ninguna palabra, ningún castigo ni venganza Podría acercarse a compensar lo que has hecho.
- I was doing my job.	-Estaba haciendo mi trabajo.
- Your job?	-¿Tu trabajo?
That was our life!	¡Eso era tu vida!
We were going to have a baby to...	Ibamos a tener un bebé..
You begged me to have a baby!	¡Tu me rogaste tener un bebé!
- I was doing my job. - Stop talking about your job!	-Estaba haciendo mi trabajo -¡Deja de hablar de tu trabajo!
You, this... Everything was a lie!	Tú, esto ¡Todo era una mentira!
My life was a lie!	¡Mi vida era una mentira!
Every feeling, every memory...	Cada sentimiento, cada memoria..
Say something to your wife, who's dying in front of you.	Dile algo a tu esposa que está muriendo enfrente tuyo
Say something.	Dí algo.
It was the shoes.	Fueron los zapatos.
What does that mean?	¿Eso qué significa?
That's when I knew.	Fue entonces cuando lo supe.
It was those brown leather shoes.	Fueron esos zapatos marrones de cuero.
It was our third or maybe fourth date.	Fue durante nuestra tercera o cuarta cita.
You'd come over to my place on Halstead, and we ordered, uh... Takeout and rented a movie that we never finished because we ended up...	Tú viniste a mi casa de Halstead, y ordenamos comida para llevar y alquilamos una película que nunca acabamos porque terminamos...
And you had to get up early for work.	Y tenías que levantarte temprano para trabajar.
And by the time I got up, you were gone.	Y para cuando me levanté, te habías ido.
I remember standing in the closet, half-dressed, reaching for my shoes when I saw that you had drawn this little heart In the dust on my shoe.	Recuerdo estar parado frente al armario, a medio vestir, buscando mis zapatos cuando ví que tu habías dibujado este pequeño corazón en el polvo sobre mi zapato.
You remember that?	¿Lo recuerdas?
It was the sweetest thing.	Fue la cosa más dulce.
And ever since that moment, I just felt... Sorry for you...	Y desde ese mismo momento, sentí lástima por ti...
Because I knew...	Por que sabía...
I knew that I had you.	Sabía que te tenía
Part of me didn't want it to work...	Parte de mi no quería que funcionara
But it did.	Pero lo hizo
Archimedes.	Arquímedes
Archimedes!	¡Arquímedes !
- I beg your pardon?	-¿Disculpa?
- Archimedes' formula.	-La fórmula de arquimedes
You know, uh, the... the naked guy who shouted "Eureka."	Tu sabes, el hombre desnudo que gritó "Eureka".
Why would she write down a mathematical formula?	¿Por qué escribiría una fórmula matemática?
Maybe it's some kind of a code or a language they don't understand.	Tal vez, es alguna clase de código o lenguaje que no entienden.
Archimedes' principle indicates that the upward buoyant force which is exerted on a body immersed in fluid,	El principio de Arquímedes indica que una fuerza flotante hacia arriba que es ejercida en un cuerpo sumerjido en fluido,
- whether fully...	-recive...
- Aram.	-Aram
Um, water displacement.	Movimientos de agua.
Boats displace water.	Los barcos desplazan agua
She's trying to tell us how they're getting her out of the country.	Ella está tratando de decirnos como la sacarán del país.
Contact the coast guard.	Contacta con la guardia costera.
Get photos of the brothers and Xiaoping Li to every port authority on the eastern seaboard.	Llevales fotos de los hermanos y Xiaoping Li A toda autoridad portuaria en la costa oriental.
What are you gonna tell him?	¿Qué le vas a decir?
Hey. What's going on?	Hey. ¿Qué sucede?
Where are we on Xiaoping Li?	¿Cómo vamos con Xiaoping Li?
They're trying to ship her out of the country.	Están tratando de enviarla fuera del país.
We're combing through the manifests now.	Nos estamos enredando con este manifiesto.
Where are you?	¿Donde estás tú?
Waiting on Reddington.	Esperando a Reddington.
He still hasn't shown.	Todavía no apareció.
I'm telling you, Keen. He used us.	Te lo digo Keen nos uso.
These guys... The Pavlovich brothers...	Estos tipos Los hermanos Pavlovich...
You remember what they did.	Recuerdas lo que hicieron.
You were there that day on the bridge.	Estabas ese día en el puente.
When we take them down, I want you to be there.	Cuando los liquidemos, quiero que estés ahí.
I will be, just as soon as...	Estaré, tan pronto como...
I'm gonna have to call you back.	Tendré que llamarte de nuevo.
Nice try.	Buen intento.
I was thirsty.	Estaba sediento.
Yes?	¿Si?
- Where is she?	- ¿Donde está ella?
- Who?	- ¿Quién?
Xiaoping Li.	Xiaoping Li.
You took her.	Tú la tomaste.
You used the FBI and the Pavlovich brothers to get to Tom and what, get Xiaoping? Make some bigger deal? Trade on her secrets?	Usaste al FBI y a los hermanos Pavlovich para llegar a Tom y qué, ¿Tomaste a Xiaoping para hacer un gran trato?
I have no use for germ warfare.	No tengo uso para la guerra biológica.
And as for using the FBI?	¿Y qué de usar al FBI?
I wouldn't be in this relationship if there wasn't a mutual benefit.	No estaría en esta relación Si no fuera por beneficio mutuo.
- Where is she?	¿Dónde esta ella?
- I don't know.	. No lo se.
I tried to bargain for her life, but negotiations went sideways.	Intenté negociar por su vida pero las negociaciones se fueron de lado
It was all I could do to get Tom.	Fue todo lo que pude hacer para tener a Tom
If we don't find her...	Si no la encontramos...
If she gets sent back to the Chinese,	Si la devuelven a los chinos
- she's gonna die.	-Va a morir.
- Tell me what you know.	-Dime lo que sabes.
We think they're putting her on a cargo ship.	Creemos que la están poniendo en un barco de carga.
We're not sure.	No estamos seguros
We're looking over the manifests, timetables, - and shipping routes. - She isn't cargo, Lizzy.	Estamos buscando en los manifiestos, los horarios, y rutas de navegación Ella no es una carga, Lizzy
She's contraband. This is a smuggling operation.	Es contrabando Eta es una operación de contrabando
And nothing gets smuggled in or out of the chesapeake without Rolph Cisco knowing about it.	Y nada sale de Chesapeake Sin que Rolph Cisco sepa.
Have Donald pay him a visit.	Haz que Donald le haga una visita
What is his obsession with you?	¿Cuál es su obsesión contigo?
You guys got, like, a, uh, daddy-daughter thing going on?	¿Es algo así como papá e hija?
What's your plan?	¿Cuál es el plan?
Is daddy coming over?	¿Papi viene para acá?
Is he gonna make me talk?	¿Viene a hacerme hablar?
No, he's not.	No.
I am.	Yo sí.
Rolph Cisco?	¿Rolph Cisco?
Tell us about the Pavlovich brothers.	Háblenos sobre los hermanos Pavlovich.
Who do you work for?	¿Para quién trabajas?
I have nothing to say.	No tengo nada que decir.
- Who do you work for?	- ¿Para quién trabajas?
- Liz, come on.	- Vamos, Liz.
You don't have it in you.	Tú no eres así. ¡Dios! ¡Déjenme salir de aquí! ¡Por favor!
Get me out!	¡Sáquenme!
Get me out!	¡Sáquenme!
It's okay.	Está bien.
It's okay.	Está bien.
Easy, easy.	Tranquila, tranquila.
We're the good guys.	Somos los buenos.
Here.	Ven.
Come here.	Ven acá.
I'm gonna put you down.	Voy a bajarte.
Easy.	Tranquila.
You broke my thumb.	Fracturaste mi pulgar.
Yeah, I did.	Sí, lo hice.
If you're looking for sympathy, you might want to start with honesty.	Si buscas simpatía tal vez quieras empezar con ser honesto.
Here's an example of honesty, Tom.	Te doy un ejemplo de honestidad, Tom.
You've been making me pancakes for two years.	Llevas haciéndome tortitas hace dos años.
- I hate pancakes.	- Odio las tortitas.
- You want honest?	- ¿Quieres honestidad?
Here's one.	Te tengo una.
If you're gonna handcuff somebody, don't break their thumb.	Si vas a esposar a alguien, no fractures su pulgar.
Your handcuffs.	Tus esposas.
One on the wrist.	Una en la muñeca.
One on the banister.	La otra en el barandal.
Do it.	Hazlo.
I am not here to hurt you, Liz.	No estoy aquí para hacerte daño, Liz.
My job was never to hurt you.	Mi trabajo nunca consistió en hacerte daño.
I'm one of the good guys.	Soy de los buenos.
Reddington...	Reddington...
He's not who you think.	No es quien piensas.
- I will find you.	- Te encontraré.
- I can prove it.	- Puedo probarlo.
The key in the lamp...	La llave en la lámpara...
I know you found it.	Sé que la encontraste.
Take it to radford bank.	Llévala al Banco Radford.
Box number 3929.	Cajilla número 3929.
He is not who you think he is.	Él no es quien tú crees.
Goodbye, Liz.	Adiós, Liz.
You want me to stop him?	¿Quieres que lo detenga?
No, we'll just let the tail follow him.	No, deja que lo sigan.
Tell me about Whitefog.	Cuéntame acerca de Niebla Blanca.
Whitefog was a black project started By the Chinese government five years ago.	Niebla Blanca fue un proyecto secreto iniciado por el gobierno chino hace cinco años.
You want to tell me what's going on with Agent Keen?	¿Quieres decirme qué sucede con la agente Keen?
- Sir?	- ¿Señor?
- Where was she today?	- ¿Dónde estuvo hoy?
And don't tell me you don't know.	Y no me digas que no lo sabes.
Was it Reddington?	¿Tiene que ver con Reddington?
Are there problems?	¿Hay problemas?
I think she's having troubles at home, sir.	Creo que tiene problemas en casa, señor.
I lost him.	Lo perdí.
He's gone.	Se fue.
No.	No.
This whole time, you've never let him out of your sight.	Todo este tiempo, nunca lo has perdido de vista.
Your people are following him now.	Tu gente lo está siguiendo ahora.
They are.	Lo están haciendo.
How is this all gonna end?	¿Cómo va a terminar esto?
This is an end.	Este es un fin.
And then something new will begin.	Y algo nuevo empezará.
You deserve the best in life, Lizzy.	Mereces lo mejor en esta vida, Lizzy.
I know that sounds odd coming from a man who has brought you some of the worst,	Sé que suena extraño viniendo de un hombre que te ha traído cosas peores
but it's the reason why Tom had to work so hard to be that for you...	pero es la razón por la cual Tom ha trabajado mucho para serlo para ti.
To be kind, to be thoughtful, make you laugh, to make you love him.	Amable, atento, hacerte reír, hacer que lo amaras.
Because you deserve that.	Porque te mereces eso.
And it will come.	Y vendrá.
The Goddess arrives in this Land	La Diosa llega a esta Tierra
Back in the days,	Tiempo atrás,
We'd look up at the sky and say "Please, God!	Mirábamos hacia el cielo y decíamos : "¡Por ​​favor, Dios!
Hurry up!"	¡Apresúrate!"
It's vague, but a theory of happiness	Es vago, pero una teoría de la felicidad.
Go, ready, go	tu, listo, tu
Unwavering, unforgiving	Inquebrantable, implacable
We've painted a precious dream	Hemos pintado un sueño precioso
Become the goddess in this world	Conviértete en la diosa de este mundo.
Forever and ever with a smile	Por siempre jamás con una sonrisa
He's Back Again~Nyo...	Ha vuelto otra vez~Nyo...
Akihabara, huh...	Akihabara, eh...
It's been a while.	Ha sido un tiempo.
Guess I'll pay that store a visit...	Supongo que haré una visita a esa tienda...
Welcome, welcome~nyo.	Bienvenido Bienvenido.
Dejiko is accepting your dues and offerings today, as usual~nyo.	Dejiko está aceptando tus cuotas y ofrendas hoy, como siempre~nyo.
?	?
Hello!	¡Hola!
Nyo?	¿tú?
I have a delivery!	¡Tengo una entrega!
No, that's wrong!	¡No eso está mal! ¡Malo malo!
Bad, bad! Not what I meant!	¡No es lo que quise decir!
Lemme start over!	¡Déjame empezar de nuevo!
Hey!	¡Ey!
How're y'all doing?	¿Cómo están todos ustedes?
Nooooo!	¡Nooooo!
That guy's foul!	¡¡¡Ese tipo es una falta!
I'm gonna throw up!	¡¡¡Voy a vomitar!
Maybe that's going a bit too far...	Tal vez eso es ir un poco demasiado lejos...
Alright, take a deep breath...	Bien, respira hondo...
Oh, Abarenbou!	¡Ay, Abarenbou!
How long has it been?	¿Cuánto tiempo ha pasado?
Don't look him in the eyes~nyo.	No lo mires a los ojos~nyo.
He'll be a pain in the ass~nyo.	Será un dolor en el culo~nyo.
He's doing that already~nyu.	Ya lo está haciendo~nyu.
Huh?	¿Eh?
Did the store change?	¿Cambió la tienda?
It seems like it's changed location.	Parece que ha cambiado de ubicación.
What did you say!	¿¡Qué dijiste!
?	?
So it changed...	Así que cambió...
It's changed since then...	Ha cambiado desde entonces...
From those days...	De aquellos días...
Or maybe it's me who changed...	O tal vez soy yo quien cambió...
I just wanted to say that line!	¡Solo quería decir esa línea!
Our customers want nothing to do with us while he's around~nyo.	Nuestros clientes no quieren tener nada que ver con nosotros mientras él está cerca~nyo.
The way he's repeating himself is pissing me off~nyu.	La forma en que se repite me está cabreando~nyu.
Oh my!	¡Oh yo!
It's huge!	¡Es enorme!
This is amazing!	¡Esto es increíble!
Otome!	¡¡¡Otome!
- Huh?	- ¿Eh?
- What's going on?	- ¿Qué está sucediendo?
Wow, he's right.	Vaya, tiene razón.
They look amazing.	Se ven increíbles.
With all that fuss he's making, I'd rather steer cleer.	Con todo ese alboroto que está armando, prefiero ir con cuidado.
Wow!	¡Guau!
Cool Japan!	¡Japón genial!
Isn't this store cool?	¿No es genial esta tienda?
We should go!	¡Deberíamos irnos!
Let's try going inside!	¡Intentemos entrar!
It sounds like a ruckus outside~nyo.	Suena como un alboroto afuera~nyo.
There's a whole crowd~nyu.	Hay toda una multitud~nyu.
Is there a celebrity out there?	¿Hay alguna celebridad por ahí?
Whew, I can't control this sudden urge to buy merch from this store!	¡Vaya, no puedo controlar este impulso repentino de comprar merchandising en esta tienda!
Business is booming!	¿¡Los negocios están prosperando!
?	?
Give me this!	¡Dame esto!
That, too!	¡Eso también!
This please!	¡Esto por favor!
Yippee!	¡Yippe!
We bought so much!	¡Compramos tanto!
Thank you very much~nyo!	¡Muchas gracias~nyo!
Thank you very much!	¡Muchas gracias!
Nyo...	Nyo...
We sold all our existing stock~nyo.	Vendimos todo nuestro stock existente~nyo.
Puchiko, are you alright~nyo?	Puchiko, ¿estás bien~nyo?
I'm fine~nyu.	Estoy bien~nyu.
I was hiding inside the shelter~nyu.	Estaba escondida dentro del refugio~nyu.
I'm beat...	Estoy exhausto...
Water...	Agua...
Get me some water...	Dame un poco de agua...
Here~nyo.	Aquí ~ nyo.
Good job~nyo.	Buen trabajo ~ tú.
Go ahead and drink some water.	Adelante, bebe un poco de agua.
COLD	FRÍO
It might stink a bit though.	Aunque podría apestar un poco.
Thanks...	Gracias...
Whew, close call.	Vaya, llamada cercana.
It'd be rude to spill water this tasty.	Sería de mala educación derramar agua tan sabrosa.
Admirable drinking~nyo!	Beber admirable ~ nyo!
This is a good store.	Esta es una buena tienda.
This store really is a keeper...	Esta tienda es realmente un guardián...
Ciao!	¡Ciao!
Thanks to Abanrenbo, our business is thriving more than ever!	¡Gracias a Abanrenbo, nuestro negocio prospera más que nunca!
We better close the store before anything else happens.	Será mejor que cerremos la tienda antes de que pase algo más.
Oh, I had a new song planned!	¡Oh, tenía una nueva canción planeada!
That was close!	¡Eso estuvo cerca!
I almost forgot about it!	¡Casi lo olvido!
Can I sing?	¿Puedo cantar?
No, don't sing!	¡No, no cantes!
The storm wiped our tension away, and it crashed bitcoin along the way~	La tormenta eliminó nuestra tensión y destruyó bitcoins en el camino~
Crashed it along the way...	Lo estrellé en el camino...
We told you not to sing~nyo!	¡Te dijimos que no cantaras~nyo!
We're out of time anyways.	Estamos fuera de tiempo de todos modos.
Let's go home and eat dinner~nyu.	Vayamos a casa y cenemos~nyu.
EVERGLOW	EVERGLOW
Ah Na Ah Na	Ah Na Ah Na
Saying 'goodbye' is a no, no	Decir 'adiós' es un no, no
Is it only something you say as a greeting?	¿Es solo algo que dices como saludo?
no, no	no no
Don't get the situation?	¿No entiendes la situación?
yeah, yeah	sí, sí
It means hide so I can't see you, just go away	Significa esconderse para que no pueda verte, solo vete
I'll count to three so hurry yeah, yeah	Contaré hasta tres, así que date prisa, sí, sí
Enough excuses now blah, blah	Basta de excusas ahora bla, bla
If possible, go as far away as you can	Si es posible, vete lo más lejos que puedas
I just wanna let you know, stay out of my sight	Solo quiero hacertelo saber, que te mantengas fuera de mi vista
Why do you make me feel so small	¿Por qué me haces sentir tan pequeño?
I always go round in circles for you	Siempre doy vueltas en círculos por ti
Why do you make me so sad	¿Por qué me pones tan triste?
I should've been the main character in the first place	Debería haber sido el personaje principal en primer lugar
Goodbye, Au Revoir, Adios (what?	Adiós, Au Revoir, Adios (¿qué?
)	)
Goodbye, Au Revoir, Adios (yeah)	Adiós, Au Revoir, Adios (sí)
Goodbye, Au Revoir, Adios (sh...)	Adiós, Au Revoir, Adios (sh ...)
Goodbye, Au Revoir, Adios	Adiós, Au Revoir, Adios
Goodbye, Au Revoir, Adios	Adiós, Au Revoir, Adios
Lalalala oh--- hey	Lalalala Oh hola
See You Later, Don't need anything, See You Later	Hasta luego, no necesito nada, hasta luego
Goodbye, Au Revoir, Adios	Adiós, Au Revoir, Adios
See You Later, Don't need anything, See You Later	Hasta luego, no necesito nada, hasta luego
Goodbye, Au Revoir, Adios	Adiós, Au Revoir, Adios
I don't seem like myself?	¿No me parezco a mí mismo?
Then I wanna go bang bang	Entonces quiero ir a bang bang
You think it's a joke cause I'm laughing, want me to hang man	Crees que es una broma porque me estoy riendo, quieres que te cuelgue hombre
NA NA to the A A to the NO NO NO	NA NA a la AA a la NO NO NO
Let me end this, now with you it's GO GO GO love me hate me, several times a day going crazy	Déjame terminar esto, ahora contigo es GO GO GO ámame, odiame, varias veces al día volviéndome loco
Like this I'm, oh ratatata---	Así estoy, oh ratatata ---
Hope you keep your mouth shut of anything about me	Espero que mantengas la boca cerrada si hablas algo mal sobre mí
I just wanna let you know, don't let it get to my ear	Solo quiero hacertelo saber, que no dejes que llegue a mis oídos
Why do you make me feel so small	¿Por qué me haces sentir tan pequeño?
I always go round in circles for you	Siempre doy vueltas en círculos por ti
Why do you make me so sad	¿Por qué me pones tan triste?
I should've been the main character in the first place	Debería haber sido el personaje principal en primer lugar
Goodbye, Au Revoir, Adios (what?	Adiós, Au Revoir, Adios (¿qué?
)	)
Goodbye, Au Revoir, Adios (yeah)	Adiós, Au Revoir, Adios (sí)
Goodbye, Au Revoir, Adios (sh...)	Adiós, Au Revoir, Adios (sh ...)
Goodbye, Au Revoir, Adios	Adiós, Au Revoir, Adios
Goodbye, Au Revoir, Adios	Adiós, Au Revoir, Adios
Lalalala oh--- hey	Lalalala Oh hola
See You Later, Don't need anything, See You Later	Hasta luego, no necesito nada, hasta luego
Goodbye, Au Revoir, Adios	Adiós, Au Revoir, Adios
See You Later, Don't need anything, See You Later	Hasta luego, no necesito nada, hasta luego
Goodbye, Au Revoir, Adios	Adiós, Au Revoir, Adios
Nanana-nananana-nanananananana	Nanana-nananana-nanananananana
Nanana-nananana-nanananananana	Nanana-nananana-nanananananana
Nanana-nananana	Nanana-nananana
Goodbye, Au Revoir, Adios	Adiós, Au Revoir, Adios
The astronomers are assembled in a large hall embellished with instruments.	Los astrónomos están reunidos en un gran cuarto repleta de instrumentos.
The president and members of the committee enter.	El presidente y miembros del comité entran.
Everybody takes his seat.	Todo el mundo toma asiento.
Entrance of six man-servants carrying the telescopes of the astronomers.	Entrada de seis sirvientes cargando los telescopios de los astrónomos.
The president takes his chair and explains to the members his plan for a trip to the moon.	El presidente toma su lugar y explica a los miembros su plan de un viaje a la Luna.
The scheme is approved by many. But one member violently opposes same.	Su plan es aprovado por muchos, pero un miembro se opone violentamente.
After some argument, the president throws his papers and books at his head.	Después de discutir, el presidente le arroja sus papeles y libros a la cabeza.
Upon order being restored, the trip proposed by the president is voted by acclimation.	Luego de que el orden se ha reestablecido el viaje propuesto por el presidente es votado por una comisión.
The man-servants bring travelling suits.	Los sirvientes les traen sus trajes de viaje.
President Barbenfouillis selects five colleagues to accompany him:	El presidente Barbenfouillis selecciona cinco colegas para que lo acompañen.
Nostradamus, Alcofrisbas, Omega, Micromegas and Parafaragamus.	Nostradamus, Acofibas, Omega, Micromegas y Bagafarraganus.
We enter the interior of the workshop where smiths, mechanics, weighers, carpenters, upholsterers, et cetera are working hard at the completion of the machine.	Entran en el interior de un taller donde herreros, mecánicos, pesadores, carpinteros tapizadores, etcétera, están trabajando duro para completar la máquina.
Micromegas accidentally falls into a tub of nitric acid.	Micromegas accidentalmente cae en un barril de ácido nítrico.
A workman informs the astronomers that if they would ascend to the roof, they will witness a splendid spectacle:	Un trabajador informa a los astrónomos que si ascendisen al techo presenciarían un espectáculo magnífico.
the casting of the gun.	La fundición del cañón.
Against the horizon, the chimneys are seen belching forth volumes of smoke.	Contra el horizonte las chimeneas están echando volúmenes de humo.
Suddenly, the flag is hoisted.	De repente una bandera es izada.
At the signal, a mass of molten steel is directed from each furnace into the mold for the gun.	Ante una señal, una masa de acero fundido es dirigida desde cada horno, hacia el molde para el cañón.
The mold pours forth flames and vapor.	El molde larga llamas y vapor.
On the top of the roofs of the town, pompous preparations have been made.	Arriba de los techos de la aldea pomposas preparaciones están llevándose a cabo.
The shell is in position, ready to receive the travelers.	El casquillo se encuentra en posición, listo para recibir a los viajeros.
These arrive respond to the acclamations of the crowd and finally enter the shell.	Estos llegan. Asienten a las aclamaciones de la multitud y finalmente entran al casquillo.
A marine closes the bridge through which they have passed.	Un marino cierra el puente por donde han pasado.
A number of gunners are pushing the shell up an incline into the mouth of the gun.	Un grupo de cañoneros empujan el casquillo hacia arriba, dentro de la boca del cañón.
The cannon is loaded.	El cañón está cargado.
The bridge is closed.	El puente está cerrado.
Everyone is waiting for the signal which starts the shell on its voyage.	Todos están esperando ansiosamente la señal que lance al casquillo en su viaje.
An officer gives the signal.	El oficial da la señal.
The gun is fired and the shell disappears into space.	El cañón es disparado. Y el casquillo desaparece en el espacio.
The shell coming closer every minute, the moon magnifies rapidly until finally it attains colossal dimensions.	El casquillo se acerca cada minuto. La luna se agranda rápidamente hasta que finalmente obtiene dimensiones colosales.
Suddenly, the shell pierces the eye of the moon.	De repente el casquillo perfora el ojo de la luna.
The shell comes down with a crash.	El casquillo aterriza con un estallido.
The astronomers get out and are delighted at the landscape which is new to them.	Los astrónomos salen y están encantados con el paisaje, que es nuevo para ellos.
Against the horizon, the Earth is rising slowly into space illuminating the picture with a fantastic light.	Contra el horizonte, la Tierra se está alzando lentamente en el espacio. Iluminando la escena con una luz fantástica.
The astronomers see craters everywhere.	Los astrónomos, ven cráteres por todos lados.
Just as they are about to explore, an explosion throws the unfortunate men violently in all directions.	Justo cuando están por explorar, una explosión arroja a los desafortunados hombres violentamente en todas direcciones.
The astronomers show signs of fatigue after the rough trip they have just had.	Los astrónomos muestran señales de fatiga, luego del duro viaje que han tenido.
They stretch themselves out on the ground and go to sleep.	Se estiran en el suelo y se van a dormir.
Seven gigantic stars representing the Great Bear appear slowly, and out of the stars come faces of women who seem annoyed at the presence of these intruders in the moon.	Siete gigantescas estrellas, representando a la Osa Mayor aparecen lentamente, y desde dentro de las estrellas aparecen caras de mujeres quienes parecen molestas ante la presencia de estos intrusos en la Luna.
Then, the stars are replaced by a lovely vision of Phoebes on the crescent, of Saturn in his globe and of charming young girls holding up a star.	Luego las estrellas son reemplazadas por hermosas visiones de Phibes en una luna cresciente.
They decide to punish the terrestrials in an exemplary manner.	De Saturno en su orbe, rodeado de su anillo y de encantadoras jóvenes sosteniendo en alto una estrella.
By order of Phoebes, snow is falling from all quarters, covering the ground with its white coat.	Deciden castigar a los terrestres de una manera ejemplar. Por orden de Phibes, la nieve cae de todos los rincones cubriendo el suelo con su tapado blanco.
So the unfortunate voyagers wake up half-frozen.	El frío se vuelve insoportable así que los desafortunados viajeros despiertan medio congelados
They decide without hesitation and in spite of the danger to descend into the interior of the great crater in which they disappear one-by-one whilst the snowstorm is still raging.	Deciden, sin titubear y a pesar del peligro, descender al interior de un gran cráter.
The astronomers arrive into the interior of a most curious grotto filled with enormous mushrooms of every kind.	Los astrónomos llegan al interior de una gruta muy curiosa, llena de enormes hongos de todas clases.
One of them opens his umbrella to compare its size with the mushroom, but the umbrella suddenly takes root and transforming itself into a mushroom starts growing attaining gigantic proportions.	Uno de ellos abre su paraguas para comparar su tamaño con el de un hongo. Pero el paraguas de repente echa raíces y transformándose en un hongo empieza a crecer gradualmente, obteniéndo gigantescas proporciones.
The astronomers suddenly notice strange beings coming out from underneath the mushrooms while making singular contortions. These are the Selenites, or inhabitants of the Moon.	Los astrónomos de repente notan extraños seres saliendo de abajo de los hongos.
A fantastical being rushes on an astronomer who defends himself and with a stroke of his umbrella the Selenite bursts into a thousand pieces.	Estos son los Selenitas o habitantes de la Luna. El fantástico ser se apresura hacia el astrónomo quien se defiende.
But the Selenites are arriving in numbers.	Y con un golpe de su paraguas el Selenita explota en mil pedazos.
The astronomers are captured, bound and taken to the palace of the King of the Selenites.	Pero los Selenitas llegan de a montones.
On a splendid throne, surrounded by living stars, the Selenite king is seated.	Los astrónomos son capturados atados, y llevados al palacio del Rey de los Selenitas.
President Barbenfouillis makes a dash for the King of the Selenites and lifting him like a feather throws him violently on the ground.	En un espléndido trono, rodeado de estrellas vivientes, se encuentra sentado el Rey Selenita.
The astronomers run away in the midst of the general disorder.	El Profesor Barbenfouillis se acerca bruscammente al Rey de los Selenitas, y levantándolo como una pluma lo arroja violentamente al suelo.
The astronomers run at full speed turning around each time they are pressed too closely and reducing the fragile beings to dust.	Los astrónomos huyen en medio del desorden general. El ejército Selenita los persigue.
At last, the astronomers have found the shell and quickly shut themselves in the interior.	Los astrónomos corren a toda velocidad, girando cada vez que son perseguidos desde muy cerca y reduciendo a los últimos seres a polvo.
Thanks to the advance, they have succeeded in getting over their adversaries. Only one, the president, has been left behind.	Finalmente, los astrónomos encuentran la nave y rápidamente se encierran en su interior.
He rushes to the rope which hangs from the point of the shell and letting himself slide down the rope he gives it an impetus which causes the shell to fall off the edge of the moon.	Gracias al avance ellos triunfan escapando del adversario. Sólo uno, el presidente, ha sido dejado atrás.
The shell falls with sickening rapidity.	Él se apresura hasta la cuerda que cuelga de la punta de la nave y dejándose deslizar por la cuerda, le da un impulso que causa que la nave caiga desde el borde de la Luna.
The shell balances and thanks to the hermetically sealed air in its interior rises slowly to the surface.	La nave cae con una rapidez que marea. El mar aparece.
The shell is picked up by a steamer which tows it to port.	La nave se balancea y gracias al aire sellado herméticamente en su interior, se eleva lentamente hasta la superficie.
The Mayor welcomes the astronomers with a speech, and the general ovation awaits their happy return.	Los hombres dan la bienvenida a los astrónomos con un discurso, y una ovación general espera su feliz regreso.
in the shop of his father, the upholsterer for the king, Jean-Baptiste Poquelin reads to his brothers and sisters his first comical verses	En la tienda de su padre, tapicero del rey, Jean-Baptiste Poquelin lee a sus hermanos y hermanas sus primeros versos cómicos.
an actor of the Comedia Italia, Tiberio Fiorelli aka Scaramouche wishes to purchase some accessories	Aquel día, un actor de la Comedia Italiana, Tiberio Fiorelli, aka Scaramouche, entra en la tienda para comprar algunos accesorios.
I dream too of playing comedy tonight at 20:00 Pearl Tavern	Yo también sueño con la escena... Esta noche, 20:00h., Taberna de La Perle
that night... at the Pearl Taverne	Por la noche... En la taberna de La Perle
a few months later, Jean-Baptiste Poquelin aka Molière founds with the Béjart family the Illustrious Theater and they tour the whole of France	Unos meses más tarde, Molière funda con la familia Béjart el Ilustre Teatro con el que irá de gira por Francia.
happy days	Días felices...
bad days	Días de penas.
at the Versailles Castle	En el castillo de Versailles.
Molière wishes an audience with King Louis 14 but he's resented by the King's court	Molière desea audiencia con el rey Luis XIV, pero es despreciado por los cortesanos.
The King	El Rey.
the monarch has invited Molière at his table	El monarca ha invitado a Molière a su mesa.
the frivolous banter of the King's Men inspired his work	Los frívolos propósitos de los cortesanos van a inspirar su obra.
a young player of his company became his wife:	Una joven actriz de su compañía se convirtió en su esposa:
Armande Béjart	Armande Béjart
his trusted maid La Forest consoles Molière when his wife is cheating he reads her his new play The Imaginary Invalid	Ella le consuela de las traiciones de su mujer  Es a ella a quien le lee su nueva obra El Enfermo Imaginario.
february 17th 1673 at the royal palace the 4th performance of the Imaginary Invalid	17 de febrero de 1673. En el palacio real, la cuarta representación de El Enfermo Imaginario.
the silly graduation of Argan as a doctor	La cómica entronización de Argan como médico.
this is not acted Molière is really dying	Esto no es teatro. Molière va a morir.
The End the intertitles for "Molière" were added in 2008 by Gaumont. This restauration was possible thanks to the original scenario located at the BNF, the department for Performance Arts	Fin
The Abyss	El Abismo
Producer:	Productor:
Hjalmar Davidsen Screenplay and Direction:	Hjalmar Davidsen Guión y Dirección:
Urban Gad Cinematography:	Urban Gad Dtor. Fotografía:
Alfred Lind	Alfed Lind
Young hearts.	Jóvenes corazones.
Duty calls.	El deber llama.
A welcome invitation	Una invitación de bienvenida.
Dear Miss Vang:	Querida Señorita Vang:
It would please my parents and myself very much, if you... would like to spend your summer vacation here at the vicarage.	Nos complacería mucho a mis padres y a mí, si a usted le apeteciese pasar las vacaciones de verano en la vicaría.
Tell me which day and train you will... be arriving on, and I'll pick you up at the station. Kind regards, Knud Svane.	Dígame el día y el tren en el que vendrá, y la recogeré en la estación.
Summer vacation.	Vacaciones de verano.
A sunday at the vicarage.	Un domingo en la vicaría.
The travelling circus.	El circo rodante.
...in the field behind the inn.	...en el campo detrás de la posada.
Performances by all artists.	Funciones de todos los artistas.
Special atraction!	¡Atracción especial!
Never seen before!	¡Nunca vista antes!
Mr. Rudolph.	Mr. Rudolph.
Cowboy and Wrangler.	Vaquero y domador.
The tightrope dancer.	La bailarina de la cuerda floja.
Miss Evelyn...	La señorita Evelyn...
A fatal promise.	Una promesa fatídica.
First time in Gjerlev! Circus Fortuna.	¡Por primera vez en Gjerlev!
Tonight amazing Galla performance... in the large tent in the field behind the inn.	Circo Fortuna. Esta noche impresionante actuación en la gran tienda detrás de la posada.
Performances by all artists.	Actuaciones de todos los artistas.
After the show.	Después de la función.
Longing and desire....	Anhelos y deseos...
I could not stay any longer.	No podía quedarme más.
I have escaped with the man I love.	He escapado con el hombre que amo.
Never think about marrying me, but forgive me.	Nunca pensaste casarte conmigo, pero perdóname.
Magda.	Magda.
Some time later in Copenhagen.	Poco después en Copenhague.
In the artists' hotel.	En el hotel de los artistas.
A coincidence.	Una coincidencia.
A forced dance rehersal.	Un ensayo forzoso de baile.
Destiny decided.	El destino decidido.
The scandal.	El escándalo.
Downhill	Al pie de la colina.
A recognition.	Un reconocimiento.
Dear Miss:	Querida Señorita:
A friend would like to talk with you	Un amigo interesado en hablar con usted
The bill must be paid.	La deuda debe ser saldada.
The one who must earn the money.	El único que debe ganar el dinero.
A wasted life.	Una vida desperdiciada.
The End.	Fin.
Dear Nelly, despite your guardian's refusal,	Querida Nelly, A pesar de la negativa de tu tutor, impondré nuestra relación
Sir, if you intend to kidnap my niece, you will likely have no luck, so don't put yourself in harm's way.	Señor, si pretende secuestrar a mi sobrina, no tendrá suerte, así que será mejor que no se exponga al peligro. Barón de Pouny
The guardian makes his preparations.	El tutor emprende sus preparativos.
Dear Nelly, your guardian resolutely opposes our union so	Querida Nelly, Tu tutor se opone rotundamente a nuestra unión.
I will carry you off by the same means as you receive this letter.	Por eso te raptaré tan pronto como recibas esta carta.
Yours, Julius	Tuyo, Julius
Preparation for departure.	Preparativos de la partida.
Subs by SickSadWorld @ KG 2022	Intertítulos traducidos por * * * toerless * * *
The Treacherous Woman (The Traitor)	La traidora
Dramatic War Story By D. J. Rector	Dramático episodio de guerra De D. J. Rector
Original Film	Film original de
Fifth film by Asta Nielsen in the 1911 Series.	Quinto film de la serie Asta Nielsen 1911.
In collaboration with:	Con la colaboración de:
Marquis de Bougival	Marqués de Bougival
- Max Obala	- Max Obal
Yvonne, his daughter	Yvonne, su hija
- Asta Nielsen	- Asta Nielsen
Lieutenant von Mallwitz	Subteniente von Mallwitz
- Rob. von Valberg.	- Rob. von Valberg.
Vujrat, leader of the partisans	Vujrat, líder de los partisanos
- Emil Albes.	- Emil Albes.
At the outpost.	En el puesto de avanzada.
Lieutenant von Mallwitz receives an order to occupy the castle.	El subteniente von Mallwitz recibe la orden de ocupar el castillo.
Tell my daughter, I wish to present the honorable lieutenant!	Dígale a mi hija, que deseo presentarla al honorable subteniente!
Between patriotism and love.	Entre patriotismo y amor.
He liked to ....	Gustarle....
Does not come .....	No viene.....
Fragrant greetings.	Saludos perfumados.
In the troops' barracks.	En el salón de la tropa.
Rejected.	Desdeñado.
A brief pause before Act II.	Breve pausa antes del II Acto.
Second act.	Segundo acto.
The temptress.	La seductora.
Alarm!	Alarma!
Duty above all else.	El deber por encima de todo.
Revenge.	Venganza.
Partisans.	Los partisanos.
10 pm:	10 pm.
The signal.	La señal.
A brief pause before Act III.	Breve pausa antes del III Acto.
Act III	Acto III
This was not intended.	No era esa su intención.
Rescue at any price.	Rescate a cualquier precio.
The last resort.	El último recurso.
It's time.	Llegó la hora.
The last bullet ...... the traitor!	La última bala ...... la traidora!
End	Fin
Script:	Continuista:
Cica Ilija Stanojevic and Cira Manok Savkovic	Cica Ilija Stanojevic y Cira Manok Savkovic.
Based on play "Karadjordje" by Milos Cvetic, epic song "Start of the uprising" and history books.	Basada en "Karadjordje" de Milos Cvetic. La canción épica "El inicio de la sublevación" y los libros de historia.
Executive producer:	Productor ejecutivo:
Svetozar Botoric Director:	Svetozar Botoric. Director:
Cica Ilija Stanojevic	Cica Ilija Stanojevic.
Karadjordje, the first Serbian feature film was filmed in summer 1911. and presented on October 23rd.	Karadjordje, la primera película serbia, fue filmada en el verano de 1911 y presentada el 23 de octubre.
For the last time, movie was presented in 1928. in USA and since than it was considered as lost.	Fue exhibida por última vez en 1928. Desde entonces fue considerada perdida.
Film was founded in Austrian film archive in Wien in July of 2003.	La película fue encontrada en el archivo Austriaco de Viena en junio del 2003.
Movie was authenticated by general manager of "Jugoslovenska kinoteka" Radoslav Zelenovic... and manager of "Arhiva jugoslovenske kinoteke" Aleksandar Erdeljanovic.	La película fue autentificada por el director general de la... "Kinoteca de Yugoslavia" Radoslav Zelenovic... y el gerente de "Archivos de la kinoteca yugoslava" Aleksandar Erdeljanovic.
This copy was made in Cine laboratory in Rome.	Esta copia fue restaurada en el laboratorio de cine de Roma.
Original movie was made without intertitles, but they were made by Aleksandar Erdeljanovic.	La copia original no llevaba intertítulos, pero fueron agregados por Aleksandar Erdeljanovic.
After Serbia was defeated in Kosovo battle in 1389, since 1459. it was occupied by Turkish empire.	Serbia fue derrotada en la batalla de Kosovo en 1389. Desde 1459. fue ocupada por el imperio Turco.
For almost four centuries Serbian people was humiliated and without any rights...	Por casi cuatro siglos los Serbios fueron humillados y no tuvieron derechos.
But Serbs believed that they are going to be free and united again some day.	Pero los serbios creían que volverían a ser libres e unificados algún día.
Man who united Serbs and brought freedom was "Father of Serbia" Karadjordje Petrovic (1762-1817).	El hombre que los unió y trajo la libertad... fue "El padre de Serbia" Karadjordje Petrovic.
14th November 1762.	14 de noviembre de 1762.
Visevac, village in Sumadija (part of Serbia)	Visevac, aldea de Sumadija.
In the house of Petar Zivkovic child was expected.	En la casa de Petar Zivkovic se esperaba un niño.
Turkish landowner came with plea to spend the night.	El terrateniente turco vino con un pretexto para pasar la noche.
- While I was praying, I saw Milos Obilic (Serbian mythical warrior)... and he was blessing the child.	- Mientras yo rezaba, vi a Milos Obilic (Mítico guerrero Serbio)... y estuvo bendiciendo al niño.
- What was it, your honor?	- ¿Qué fue eso, su honor?
Petar, the terrible lion came in my dream and ate me, but Childs voice awoke me.	Un terrible león vino en mis sueños para comerme, pero el llanto del niño me despertó.
I want to see that child.	Quiero ver a ese niño.
Your son will be great man.	Tu hijo será un gran hombre.
Take good care of him and always remember what I told you.	Cuídalo bien... y siempre recuerda lo que te dije.
Years were passing by.	Los años fueron pasando.
Little Djordje liked to play Serbs and Turks, but he enjoyed most... listening epic songs about Kosovo battle and death of sultan Murat who was killed... by Milos Obilic, great hero.	Al pequeño Djordje le gustaba jugar a Serbios y Turcos, pero disfrutaba más... escuchar las canciones épicas sobre la batalla del Kosovo y la muerte del sultán Murat... quién fue asesinado por Milos Obilic, el gran héroe.
Once, vicious Turk came to Djordje, little Shepard.	Una vez, un Turco vicioso vino donde Djordje, en Sheperd.
Righteous anger.	Odio legítimo.
More years passed by.	Más años han pasado.
Girls were coming to the spring to talk, but Jelena was waiting for someone.	Con la primavera las niñas vienen a conversar... pero Jelena esperaba a alguien.
I'm fond of you.	- Le parezco agradable.
I'd like to take you to be my wife.	Me gustaría tomarla por esposa.
Envious and angry father.	El padre envidioso y enojado.
Djordje got married.	Djordje se casó.
But soon, Turks came to his hose in Topola.	Pero pronto, los turcos vinieron a su casa en Topola.
Their leader was janissary Adem.	Su líder fue janissary Adem.
Grandma' roast ram!	- ¡Abuela, carnero asado!
And you bride, come to serve, as you will be tonight.	- Y la novia... venga a servirnos, también lo será ella esta noche.
- You are threatening, but how you are going to... your master and Sultans son? - Don't you know that Serb would kill anyone for his honor?	- ¿No sabes que el Serbio mataría por su honor?
- Just like this!	- ¿A tu amo e hijo de sultanes? - ¡Es lo justo!
For some time, Djordje was outlaw with Stanoje Glavas and he killed more Turks.	Por algún tiempo, Djordje estuvo fuera de la ley... con Stanoje Glavas y mató mas Turcos.
Turks called him Black Djordje because of his dark ten.	Los Turcos lo llamaron Djordje el negro.
In fear of Turkish revenge, he went Over Sava river to Srem, but... His stepfather Petronije changed his mind and said that he is going to give them away to Turks if they don't come back.	Por temor a la represalia Turca, el fue por el río Sava a Srem, pero... su suegro Petronije cambió de opinión y dijo que los entregaría a los Turcos si ellos no regresaban.
It's better for me to kill him and be responsible in Gods eyes than to let Turks to kill us all.	Es mejor matar y ser responsable ante Dios... a dejar que los Turcos nos maten a todos.
Base of Austrian army in Sombor 1787.	Base del ejército Austriaco en Sombor, 1787.
Fighting bravely, Karadjordje became sergeant in Austrian army, but he was homesick.	Luchando valerosamente, Karadjordje... llega a sargento en el ejército austriaco, pero extrañaba su tierra.
There was no comfort.	No había comodidad.
As soon as he read confidential letter form Serbia, he decided... that he doesn't want to get killed for others when time for battles in Serbia is coming.	En cuanto leyó una carta confidencial de Serbia, lo decidió... no quería morir por otros... cuando en Serbia las batallas comenzaban.
Hidden by the shelter of the night, again in Serbia.	Ocultado por la oscuridad de la noche, llegó a Serbia.
After murder of Just Mustafa in 1801.	Luego asesinó a un Mustafá en 1801.
Serbia was under seven Turkish outlaws.	Serbia estaba bajo los proscritos turcos.
Robberies, raping, taking children into slavery became very often.	Los robos, violaciones, la esclavitud infantil... se hicieron usuales.
By the ending of 1803. Serbs decided to organize uprising.	A fines de 1803, los Serbios decidieron organizar el levantamiento.
Turkish landlords started consultations in Belgrade tower "Nebojsa".	Los propietarios Turcos se reunieron a consultar en la torre "Nebojsa".
They were looking for signs from the sky.	Buscaban las señales del cielo.
In casserole they saw their bodies without heads.	En la cacerola vieron sus cuerpos sin cabezas.
In holly books they founded confirmation of their near ending, because of their actions.	En sus libros sagrados confirmaron... la cercanía de su final, debido a sus actos.
They refused advice of their father Foca (100 years old) to be kind to the Serbs.	Rechazaron el consejo de su padre Foca... (Cien años atrás) de ser amables con los serbios.
Worst among them, Focic Mehmed-aga suggests killing leaders: Palalija, Bircanin, Carapic and Karadjordje.	El peor de ellos, Focic Mehmed-aga... aconseja matar a los líderes:
After death of more than 80 significant people, Serbs realized that it is time for uprising.	Luego de la muerte de 80 personas importantes... los serbios comprenden que es hora de levantarse.
