Cooper:	COOPER:
Previously on "The Blacklist"...	בעבר על "הרשימה השחורה"...
- You want to call your daddy?	- אתה רוצה לקרוא לאבא שלך?
- Yeah, I want to tell him I'm okay.	- כן, אני רוצה להגיד לו שאני בסדר.
Okay.	אוקיי.
Lizzy...	יזי...
Be careful of your husband.	היזהר של בעלך.
I can only lead you to the truth.	אני יכול רק להוביל לך את האמת.
I can't make you believe it.	אני לא יכול לגרום לך להאמין בו.
She's calling herself Jolene Parker.	היא קוראת לעצמה Jolene פרקר.
Elizabeth Keen is not your wife, she's your target.	אליזבת קין היא לא אשתך, שהיא היעד שלך.
Liz:	ליז:
You have been threatening to tell me the truth about my husband since the day we met, and I'm ready to listen.	אתה כבר מאיים לספר לי את האמת על בעלי מאז אותו היום שנפגשנו, ואני מוכן להקשיב.
Red:	נכון לעכשיו, הדבר היחיד שחשוב הוא האיום המיידי... אדום:
Your husband... Finding out who he is and who he works for.	בעלך... מציאת מי הוא ומי הוא עובד.
The rest will come.	השאר יבוא.
I promise you.	אני מבטיח לך.
[Speaking Mandarin]	(אם כבר מדברים מנדרינית)
[Speaking Mandarin]	(אם כבר מדברים מנדרינית)
[Engine turns over]	(מנוע מתהפך)
[Siren wailing] Asset on board.	(יללות סירנה) נכסים על לוח.
En route.	בדרך.
12 cc epinephrine.	אפינפרין סמ"ק 12.
[Defibrillator beeps] Clear.	(דפיברילטור צפצופים) ברור.
[Wailing continues]	(יללות ממשיכה)
- 45 seconds.	45 שניות.
[Alarm blaring]	(הרועם ALARM)
We need more adrenaline.	אנחנו צריכים יותר אדרנלין.
Cover her mouth.	כסה את הפה שלה.
[Needle pierces] [Gasps]	(מחט חודר) (נשימות)
Man:	MAN:
It's okay.	זה בסדר.
It's okay.	זה בסדר.
It's okay.	זה בסדר.
Shh!	ששש!
It's okay.	זה בסדר.
You're okay.	אתה בסדר.
You're okay.	אתה בסדר.
Rest.	לנוח.
You'll be in America by morning.	אתה תהיה באמריקה עד הבוקר.
We're taking you to Washington, D.C.	אנחנו לוקחים אותך לוושינגטון
Do you know where the prisoner was transported to?	האם אתה יודע איפה האסיר הועבר ל?
Uh, Washington.	אה, וושינגטון.
Okay.	אוקיי.
Yes, we'll take care of it.	כן, אנחנו נדאג לזה.
Very good.	טוב מאוד.
[Cellphone beeps]	(הסלולר צפצופים)
Washington?	וושינגטון?
[Chuckles] [Chuckles]	(מגחך) (מגחך)
Since when did Jolene Parker's case go from missing person to murder investigation?	ממתי המקרה של ג'ולין פרקר ללכת מאדם חסר לרצוח את החקירה?
Tom:	TOM:
- And have you seen my keys?	- ואולי ראית את המפתחות שלי?
- It's crazy, right?	- זה מטורף, נכון?
Yeah, what, uh...	כן, מה, אה...
What happened?	מה קרה?
The police say they have a person of interest.	המשטרה אומרת שהם אדם של עניין.
Really?	באמת?
Who is it?	מי זה?
What do they...	מה הם...
What do they know?	מה הם יודעים?
They're not sure.	הם לא בטוחים.
Isn't it possible that she just left town like she said?	האם זה לא יכול להיות שהיא פשוט עזבה את העיר כמו שהיא אמרה?
Moved to Dayton?	הועבר לדייטון?
They found blood...	הם מצאו דם...
Matches hers.	גפרורים שלה.
You see this stuff every day... You know, people getting hurt and killed... and...	אתה רואה את הדברים האלה כל יום... אתה יודע, אנשים להיפגע והרגו...
I don't.	אני לא.
It freaks me out.	זה פריקים אותי החוצה.
Just the thought of that happening to you, you know... Just promise me you're as careful as you can be when you're at work.	רק המחשבה שזה יקרה לך, אתה יודע... רק תבטיח לי שאתה כזהיר כפי שאתה יכול להיות
- The desk.	- השולחן.
- Hmm?	- הממ?
By the computer...	ידי המחשב...
That's where I saw your keys.	זה מקום שבו ראיתי את המפתחות שלך.
Oh.	אה.
I'm gonna be so late.	אני הולך להיות כל כך מאוחר.
I'm gonna give myself a tardy slip.	אני הולך לתת עצמי תלוש מאוחרת.
Found 'em!	נמצא אותם!
They were under the newspaper.	הם היו מתחת לעיתון.
What would I do without you?	מה הייתי עושה בלעדיך?
I got to run.	אני חייב לרוץ.
Uh, tonight for dinner, let's check out that new thai place.	אה, ערב לארוחת ערב, בואו לבדוק את שהמקום תאילנדי חדש.
He knows something's off.	הוא יודע את של משהו.
What makes you say that?	מה גורם לך להגיד את זה?
I can feel it.	אני יכול להרגיש את זה.
I know him.	אני מכיר אותו.
Tom is on his heels.	טום הוא על עקביו.
He's behaving erratically.	הוא מתנהג באופן לא סדיר.
He killed Jolene Parker.	הוא נהרג Jolene פרקר.
Yes.	כן.
You knew?	אתה ידעת?
Why didn't you tell me?	למה לא ספרת לי?
I felt if I told you it would inform your behavior with him.	הרגשתי אם הייתי אומר לך שזה היה ליידע ההתנהגות שלך איתו.
I found her body, called the police, and reported a missing person.	מצאתי את גופה, התקשרה למשטרה, ודיווחתי על אדם חסר.
I was confident, in the course of their investigation, they would reach out to you and Tom, and they did.	אני היה בטוח, ב במהלך חקירתם, הם יגיעו אליך וטום, והם עשו.
Jolene Parker undoubtedly worked for the same organization as Tom... In what capacity, I have no idea.	Jolene פרקר ללא ספק עבד באותו הארגון כמו טום... באיזה תפקיד, אין לי מושג.
If they worked together, why would he murder her?	אם הם עבדו יחד, למה ​​שהוא ירצח אותה?
Perhaps he was ordered to.	אולי הוא נצטווה.
Or perhaps he's just...	או אולי הוא פשוט...
Out of control, irrational... Paranoid and reactionary.	מתוך שליטה, לא הגיוני... פרנואיד וריאקציונר.
He's scrambling for a foothold, and therein lies our opportunity to wait and to watch.	הוא נאבק על דריסת רגל, וכאן טמונה ההזדמנות שלנו לחכות ולראות.
But Tom is not the reason I'm here.	אבל טום לא הסיבה שאני כאן.
I'm afraid there's something quite timely afoot.	אני חושש שיש משהו די הזמן להתבשל.
The Pavlovich brothers are back in town.	האחים פבלוביץ' הם שוב בעיר.
You're talking about the team from the bridge that grabbed the general's daughter.	רסלר: אתה מדבר על הקבוצה מהגשר שתפס התו של הגנרל.
Liz:	ליז:
They're an extraction team... Cut their teeth on Milosevic's protective detail during the ethnic cleansing of the Yugoslav wars.	הם צוות חילוץ... חותכים את שיניהם בפירוט ההגנה של מילושביץ' במהלך הטיהור האתנית של מלחמות יוגוסלביה.
We lost six of our men that day.	איבדנו שישה מאנשינו באותו היום.
[Gunfire, grunting]	(ירייה; גונח)
[Grunts]	(נהמות) למיטב ידיעתנו,
To the best of our knowledge, the Pavlovich brothers have no political agenda.	יש האחים פבלוביץ' אין אג'נדה פוליטית.
They specialize in snatch-and-grabs ranging from kidnap and ransom to extracting political dissidents.	הם מתמחים בלחטוף-and-תופס הנע מחטיפה וכופר לחילוץ מתנגדי משטר פוליטי.
Reddington says he has a contact.	רדינגטון אומר שיש לו קשר.
A money launderer sourced by the brothers claims they're coming after a Chinese scientist named Xiaoping Li.	מלבין כספים שמקור ידי האחים טוען הם באים אחרי מדען סיני בשם שיאופינג לי.
- What do we know about her?	- מה אנחנו יודעים עליה?
- 18 hours ago, the agency sent an undercover team to extract her from a clandestine labor camp in the Yunnan province.	- לפני 18 שעות, הסוכנות שלחה צוות סמוי כדי לחלצה ממחנה עבודה חשאי במחוז יונאן.
- Break her out?	- לשבור אותה?
Why? - She's an immunologist... Specializes in viral and bacterial diseases.	- היא היא אימונולוג... מתמחה בנגיפי ומחלות חיידקים.
Four months ago, she signaled to one of our assets that she had a willingness to talk about a secret weapons program.	לפני ארבעה חודשים, היא אותתה לאחד מהנכסים שלנו שיש לה נכונות לדבר על תכנית נשק חשאי.
A month later, she was jailed for treason.	חודש לאחר מכן, היא נכלאה בעוון בגידה.
She's scheduled to land at Andrews in an under an hour, and we have a team standing by to escort her to Langley	היא מתוכננת לנחות באנדרוס בפחות משעה, ויש לנו עומד צוות ידי ללוות אותה לנגלים
- for a debriefing.	- לתחקיר.
- We got to assume that the Pavlovich brothers already know the route.	- יש לנו להניח שהאחים פבלוביץ' כבר יודעים את המסלול.
Well, then we'll reroute her.	טוב, אז אנחנו לנתב אותה.
Bring her here.	תביא אותה כאן.
Coordinate the adjustment with Langley.	לתאם התאמת עם לנגלי.
[Helicopter blades whirring]	(זמזום להבי מסוק)
Man:	MAN:
Echo to tango.	אקו לטנגו.
Uh, asset at drop point.	אה, נכס בשלב ירידה.
Man #2:	♪ MAN 2:
Roger. 30 seconds to rendezvous.	רוג'ר. ♪ ♪ 30 שניות למפגש.
- This way.	- בדרך זו.
Quickly. - Li:	במהירות.
What's going on?	- LI: מה קורה פה?
They said I'd be safe once I arrived.	הם אמרו שאני יהיה בטוח ברגע שהגעתי.
We have a credible threat you're being targeted.	יש לנו איום אמין אתה על כוונת.
As a precaution, we've altered our route.	כאמצעי זהירות, אנחנו כבר שיניתי המסלול שלנו.
Get her up to the chopper.	קבל אותה עד המסוק.
[Tires screech]	(חריקת גלגלים)
Donald Ressler.	דונלד רסלר.
FBI.	ה-FBI.
Where's the asset?	איפה הוא הנכס?
- Ground transport's been arranged.	- תחבורת קרקע כבר מסודרת.
- Negative.	העברה לפרוטו בטא... (ירייה; - שלילי.
Evac's been compromised.	העוצבתי שנפרץ.
Moving to beta proto... [Gunfire, Li screams]	LI צרחות)
[Whimpering] Call it in.	(מייבב) תקרא לזה פנימה
[Gunshots] [Helicopter blades whirring]	(יריות) (זמזום להבי מסוק)
[Gunfire] [Shouts indistinctly]	(יריות) (צעקות מעורפלת)
All right.	בסדר.
Okay.	אוקיי.
Copy that.	העתק את זה.
Anne Arundel county sheriff's department's reporting a downed aircraft burning two miles outside of Crofton.	מחוז אן Arundel הדיווח של מחלקת שריף מטוסים שהופלו שריפת שני קילומטרים מחוץ קרופטון.
There's no witnesses on the ground.	אין עדי על הקרקע.
We do have units en route.	יש לנו יחידות בדרך.
It's got to be the dump site	הוא חייב להיות אתר מזבלה
- on this chopper.	- הם ידעו שפרוטוקול ה-CIA... שאם המסלולים היו נפגעים, הם היינו שולחים בסיוע אווירי. - על המסוק הזה.
These guys weren't based domestically.	החבר 'ה האלה לא היו מבוסס מבית.
They snuck in, and they're gonna sneak out.	נכנס בגניבה, והם הולכים להתגנב החוצה.
We should coordinate with homeland, get their faces everywhere.	אנחנו צריכים לתאם עם מולדת, לקבל את פניהם בכל מקום.
Agent Malik, you want to tell me why the director of national intelligence is calling?	הסוכן מאליק, אתה רוצה לספר לי מדוע מנהל המודיעין הלאומי הוא קורא?
What don't I know about this case?	מה אני לא יודע על המקרה הזה?
The program Li was working on...	התכנית לי היה עובד על...
It's germ weaponry... Banned by nearly every nation on Earth.	זה נשק נבט... מגורש על ידי כמעט כל אומה על פני כדור הארץ.
It's called Whitefog.	זה נקרא Whitefog.
Day before she was jailed, Xiaoping Li sent a message indicating that she had access to the designs.	יום לפני שהיא הייתה כלוא, שיאופינג Li שלח הודעה מצביע על כך שהייתה לה גישה לעיצובים.
If she did, and she shared those with us, that would represent the biggest intelligence coup in a decade.	אם היא עשתה, והיא משותפת אלה איתנו, שייצג את הפיכת מודיעין הגדולה ביותר בעשור.
A germ-warfare program?	תכנית של הלוחמה ביולוגית?
That's why the Chinese can't turn this into an international incident.	לכן הסיני לא יכול להפוך את זה לתקרית בינלאומית.
[Cellphone vibrating]	(רטט הסלולר)
- Red:	- אדום:
Where are you?	איפה אתה?
- Busy.	- עסוק.
The brothers...	האחים...
They took Xiaoping Li.	הם לקחו לי שיאופינג.
How do you know?	איך אתה יודע?
Do you have a lead?	האם יש לך יתרון?
Something we can...	משהו שאנחנו יכולים...
- Your husband is not in school.	- בעלך הוא לא בבית הספר.
- Wait.	- חכה.
What?	מה?
Where is he?	איפה הוא?
Meet me at 9th and Constitution.	פגוש אותי ב-9 וחוקה.
[Cellphone beeps]	(הסלולר צפצופים)
Reddington says he has a lead on the brothers.	רדינגטון אומר שיש לו להוביל על האחים.
Wants to talk.	רוצה לדבר.
Let me know what NTSB says about that downed aircraft.	תודיע לי מה אומר NTSB על שמטוסים שהופלו.
Called in sick this morning.	הודיע ​​שהוא חולה הבוקר.
Returned home briefly before making a stop at the Radford Bank in Adams Morgan.	חזר הביתה לזמן קצר לפני ביצוע הפסקה בבנק רדפורד באדמס מורגן.
He's made three phone calls...	הוא עשה שלוש שיחות טלפון...
All from pay phones.	כל מטלפונים ציבוריים.
He's been sitting at that cart for nearly an hour.	הוא כבר יושב באותו הסל במשך כמעט שעה.
I'm sorry, Lizzy.	אני מצטער, ליזי.
Don't be.	אל תהיה.
This must be difficult.	זה חייב להיות קשה.
You want to know what's hard?	אתה רוצה לדעת מה הוא קשה?
Sitting here when all I really want to do is get my hands around his throat.	יושב כאן כש כל מה שאני באמת רוצה לעשות הוא לקבל את הידיים שלי סביב גרונו.
[Indistinct conversations]	(CONVERSATIONS לא ברור)
- Shouldn't we follow him?	- לא כדאי לנו לעקוב אחריו?
- We are.	- אנחנו.
They all work for you.	כולם עובדים בשבילך.
Lizzy, wait, wait, wait.	יזי, מחכה, חכה, חכה.
What are you do... [Door closes] [Horn honks]	מה אתה... (דלת נסגר) (הורן צופר)
[Indistinct conversations]	(CONVERSATIONS לא ברור)
Not now.	לא עכשיו.
[Indistinct conversations]	(CONVERSATIONS לא ברור)
[Camera shutter clicks]	(קליקים תריס מצלמה)
[Camera shutter clicks]	(קליקים תריס מצלמה)
[Camera shutter clicking]	(לחיצה על תריס מצלמה)
Li: [Panting]	LI: (מתנשף)
The boat...	הסירה...
How long for the boat?	כמה זמן לסירה?
[Speaking serbian]	(אם כבר מדברים סרבי)
Li:	LI:
No. No. Please, no.	לא, לא, בבקשה לא.
[Air hisses] [Gasps]	(AIR לוחש) (נשימות)
["The American waltz" plays]	("האמריקאיוולץ"נצחונות)
[Door closes] Liz:	- (דלת נסגר) - ליז:
Tom?	טום?
Tom?	טום?
I'm in the dining room.	אני בחדר האוכל.
Where'd you get that thing?	איפה יש לך את הדבר הזה?
I was gonna ask you the same question.	אני היה הולך לשאול אותך את אותה השאלה.
I found it in the basement.	אני מצאתי אותו במרתף.
That's where that was.	זה המקום שהיה.
I've been looking for it.	אני כבר מחפש את זה.
My father gave it to me.	האבא שלי נתן לי.
[Music stops] It's beautiful. It's in great condition, too.	(מוסיקהנפסקת) זה יפה  זה במצב מצוין, יותר מדי.
It looks almost new.	זה נראה כמעט חדש.
Why haven't I seen this before?	למה אני לא ראיתי את זה קודם?
[Pot lid rattling] Your pot is gonna boil over.	(מכסה של סיר שקשוק) סיר שלך הוא רתיחה הולכת מעל.
You're cooking?	אתה מבשל?
I thought we were going out for thai.	חשבתי אנחנו יוצאים לתאילנד.
Yeah, well, I just thought it might be nice, you know, to stay home alone...	כן, טוב, אני רק חשבתי זה יכול להיות נחמד, אתה יודע, להישאר בבית לבד...
Just you and me.	רק אתה ואני.
How was your day?	איך היה היום שלך?
It was exhausting. [Chuckles softly]	זה היה מתיש.
You know Billy Salter?	(מגחך חרש) אתה יודע בילי סאלטר?
He was acting up again 'cause his mom keeps packing these fruit roll-ups, and they give him this satanic sugar high, you know.	הוא היה מתנהג שוב כי אמא שלו שומרת על אריזת אלה מגולגלי פירות, והם נותנים לו את זה שטני סוכר גבוה, אתה יודע.
So... Oh, uh, I did stop by the national archives just to maybe book a field trip for the kids.	אז... אה, אה, אני לא אפסיק ידי הארכיונים הלאומיים רק כדי אולי ספר טיול שדה לילדים.
It's funny.	זה מצחיק.
I, uh... I could have sworn that I saw you there.	אני, אה... יכולתי להישבע שראיתי אותך שם.
There was a woman there, and she looked just like you.	הייתה שם אישה שיש, והיא נראתה בדיוק כמוך.
Ah, no, I wish.	אה, לא, אני רוצה.
I was cooped up in the office all day.	הייתי כלוא במשרד כל היום.
Yeah.	כן.
Should have known.	צריך לדעת.
Well, whoever she was, she could not have been half as beautiful as you are right now.	ובכן, מי שהיא הייתה, שהיא לא הייתה יכולה להיות חצי יפה כמו כמו שאתה עכשיו.
All right.	בסדר.
Uh, keep stirring.	אה, לשמור על ערבוב.
I'm gonna walk the dog.	אני הולך לטייל עם הכלב.
Come on, bud.	יאללה, ניצן.
Hey, hey, hey. [Smooches] Come here.	היי, היי, היי. (SMOOCHES) בוא הנה.
Hey, hey, hey.	היי, היי, היי.
Where you going?	לאן אתה הולך?
[Smooches] Come here.	(SMOOCHES) בוא לכאן.
Come here.	בואו לכאן.
Yes, you're a good boy.	כן, אתה ילד טוב.
Yes, you are.	כן, אתה.
Yes, you are.	כן, אתה.
What?	מה?
Nothing.	שום דבר.
Love you.	אוהב אותך.
I'll be right back.	אני מייד חוזר.
Come on, bud. [Smooches] Come on.	בחייך, ניצן. (SMOOCHES) בחייך.
Come on.	קדימה.
Such a good boy.	כזה ילד טוב.
You're a good boy.	אתה ילד טוב.
Yes, yes, yes.	כן, כן, כן.
[Door closes]	(דלת נסגר)
[Scratching on door]	(מגרד על דלת)
[Cellphone snaps]	(הסלולר מצליפה)
[Coin clinks] [Dialing]	(COIN נקישות) (חיוג)
Woman:	אישה:
Bantam finance.	מימון בנטם.
How may I direct your call?	איך אני יכול לנתב את השיחה שלך?
Hi.	היי.
I'm having a problem with my account.	אני נתקל בבעיה עם החשבון שלי.
Uh, number Delta, Sierra, 4-5-1.	אה, מספר דלתא, סיירה, 4-5-1.
[Beeps] Line is secure.	(צפצופים) קו מאובטח.
Proceed.	המשך.
Mockingbird knows.	זמיר יודע.
Requesting immediate evac.	בקשה העוצבתי מיידי.
She knows.	היא יודעת.
[Receiver clicks]	(מקלט קליקים)
[Key fob clinks, keys jingle]	(נקישות KEY FOB, מפתחות ג'ינגל)
He's gone.	הוא נעלם.
My husband is gone.	הבעל שלי כבר אינו.
Your husband never existed.	בעלך מעולם לא היה קיים.
Lizzy, I understand why you went after Tom today.	ליזי, אני מבין למה אתה הלך אחרי טום היום.
The instinct to jump in is... [Sighs]	האינסטינקט לקפוץ בהוא... (נאנח)
But it isn't gonna serve you well here.	אבל זה לא הולך ישרת אותך היטב כאן.
And from the emotional point of view, this must feel like an extraordinary violation and betrayal.	ומ נקודת מבט הרגשי, זה בטח מרגיש כמו יוצא דופן פגיעה ובגידה.
But for Tom it was business.	אבל לטום זה היה עסקי.
Do you know we had sex the other night?	האם אתה יודע שאנחנו לא מין באותו הלילה?
Do you have any idea how filthy that makes me feel?	האם יש לך מושג איך מטונף שגורמת לי להרגיש?
Unfortunately, Lizzy, you're chest-deep in filth, and you're gonna have to wade through it	למרבה הצער, ליזי, אתה חזה עמוק בזוהמה, ואתה הולך לי לדשדש זה
- to get to the other side.	- כדי להגיע לצד השני.
- I fell in love with him.	- אני התאהבתי בו.
I married him.	נישא לו.
We... we were gonna have... I was excited to have a child with him.	... היו יש לנו אנחנו הולכים... הייתי נרגש לקבל ילד איתו.
He was the one person I chose in my life who made me happy, who made me feel safe.	הוא היה האדם אחד אני בחרתי בחיים שלי שעשה אותי מאושר, שגרם לי להרגיש בטוח.
What does that say about me?	מה זה אומר עליי?
Everything that we had was just a figment of my imagination... Worse than a figment...	כל מה שהיה לנו היה רק ​​ פרי הדמיון שלי... גרוע מפרי...
A lie.	שקר.
It was right in front of my face, and I didn't see it.	זה היה ממש מול הפנים שלי, , ואני לא רואה את זה.
I just... believed it.	אני פשוט... האמנתי בזה.
All of it.	כל זה.
Time is the only thing that will allow you to find yourself again.	זמן הוא הדבר היחיד שיאפשר לך למצוא את עצמך שוב.
If you tell me to be patient one more time, I swear to God...	אם תגיד לי להיות סבלני עוד פעם אחת, אני נשבע באלוהים... אני הולך למצוא אותו, אני הולך למצוא את התשובות,
I am going to find him, I'm gonna find answers, and I'm going to do it with or without your help.	ואני הולך לעשות את זה עם או בלי העזרה שלך.
[Cellphone vibrating] [Sighs] The case. I need a lead.	(רטט הסלולר) (נאנח) המקרה.
Lizzy, if you want to find where the Pavlovich brothers are, you need to find out where they've been.	ליזי, אם אתה רוצה למצוא בי האחים פאבלוביץ' הם, אתה צריך לברר שבו הם הייתם.
The helicopter is key.	המסוק הוא מפתח.
The Pavlovich brothers burnt that chopper to cover up evidence... DNA, fingerprints.	האחים פבלוביץ' שרוף שמסוק כדי לחפות על ראיות...
Those things might have identified the brothers, but what about the chopper?	הדברים האלה אולי זיהו את האחים, אבל מה עם המסוק?
The tail numbers were falsified, and the chopper was repainted.	מספרי הזנב זויפו, והמסוק היה נצבע מחדש.
That's what they did, but where did they do it?	זה מה שהם עשו, אבל שבו הם עשו את זה?
Is there a deeper forensic analysis we can run?	האם יש ניתוח משפטי עמוק יותר שאנחנו יכולים לרוץ?
What particulates were in the heat exchange?	מה חלקיקים היו בהחלפת החום?
Was there moisture in the compressor?	האם היה לחות במדחס?
I'll reach out to forensics.	אני יהיה להגיע לזיהוי פלילי.
Analyze every drop of fuel.	לנתח כל טיפה של דלק.
Track every grain of sand.	עקוב אחר כל גרגר החול.
I want to know where that chopper's been.	אני רוצה לדעת איפה המסוק שהיה.
That's him.	כלומר אותו.
[Indistinct conversations] [Horn honks]	(CONVERSATIONS לא ברור) (הורן צופר)
I'm sorry, man.	אני מצטער, אחי.
Not for hire.	לא להשכרה.
Hello, Symir.	שלום, Symir.
I'll be brief and to the point.	אני אהיה קצר ולעניין.
Yesterday you had a customer... Picked him up outside the national archives.	אתמול היה לך לקוח... הרים אותו מחוץ ל הארכיונים הלאומיים.
Sorry, man.	מצטער, אחי.
Ohh, Symir.	אוו, Symir.
You should have taken the money.	אתה צריך לקחת את הכסף.
Your passenger...	הנוסעים שלך...
Where'd you drop him?	איפה להוריד אותו?
[Bell tolls]	(צלצל פעמון)
[Chuckles] Calculus.	(מגחך) חדו"א.
I can't even think about derivatives without thinking of that tutor in manor hall... Cindy something-or-other.	אני לא יכול אפילו לחשוב על נגזרי מבלי לחשוב ש המורה באולם אחוזה... סינדי כזה או אחר.
Never wore a brassiere;	לעולם לבש חזייה;
Always a bounce in her step.	תמיד להקפיץ בשלב שלה.
Look, I'm talking, cooperating.	תראה, אני מדבר, משתף פעולה.
You don't need to copy my driver's license, my credit cards.	אתה לא צריך להעתיק את רישיון הנהיגה שלי, כרטיסי האשראי שלי.
We just want to make sure we know where to reach you, Geoffrey P. Seevers, should we have more questions.	אנחנו רק רוצים לוודא אנחנו יודעים איפה להשיג אותך, ג'פרי פ Seevers, צריך יש לנו יותר שאלות.
So, tell me about the book.	אז, לספר לי על הספר.
I told you...	אמר לך...
I pick up and drop off.	אני מרים ולנשור.
I don't know names.	אני לא יודע שמות.
I'm the messenger.	אני השליח.
What is it?	מה זה?
Some kind of code?	איזה קוד?
How many times have you done this... these drops?	כמה פעמים שעשיתם את זה... טיפות אלה?
This was the fourth.	זו הייתה רביעית.
I need you to write down the location of each drop you've made... The pickup and the drop location.	אני צריך שתרשום את מיקומו של כל טיפה שביצעת... טנדר ומיקום הטיפה.
[Chuckling] Oh, my God.	(מצחקק) הו, אלוהים שלי.
What?	מה?
Pagosa Springs public library?	ספרייה ציבורית Pagosa Springs?
I had a water pump go out in Pagosa Springs.	הייתי משאבת מים לצאת בPagosa ספרינגס.
Bitch of a mountain...	כלבה של הר...
Wolf Creek Pass.	Wolf Creek Pass.
Thought I was gonna end up living out there with the hill people until this Teddy bear of a man fixed me up at the local garage.	חשבתי שאני הולך בסופו של דבר החיים בחוץ עם אנשי הגבעה עד דובון זה של גבר סדר לי במוסך המקומי.
I'll never forget him.	אני לעולם לא אשכח אותו.
Tracy Woods.	טרייסי וודס.
You don't know Tracy, do you?	אתה לא יודע טרייסי, נכון?
Leather vest, mustache...	אפוד עור, שפם...
Tracy Woods?	טרייסי וודס?
No. [Laughs]	מס (צוחק)
I wonder if he's still fixing water pumps.	אני תוהה אם הוא עדיין משאבות מים תיקון.
Anyway, it'll always be a fond memory.	בכל אופן, זה יהיה תמיד להיות זיכרון נעים.
The list.	הרשימה.
S-so, that's it?	S-כל כך, כי זה?
We're... What about the package?	אנחנו... מה עם החבילה?
You're gonna deliver it or return it or whatever the people you work for want you to do with it.	אתה הולך לספק אותו או להחזיר אותו או מה שהאנשים שאתה עובד לרוצה שתעשה עם זה.
And as far as you're concerned, we never had this conversation.	וככל מודאגים אתה, לא היה לנו את השיחה הזאת.
Dembe?	Dembe?
A copy, please.	עותק, בבקשה.
I hope you have nothing pressing.	אני מקווה שיש לך שום דבר דחוף.
This may take a minute or three.	זו עשויה להימשך דקה או שלושה.
You sure you don't know him?	אתה בטוח שאתה לא מכיר אותו?
Leather vest, mustache...	אפוד עור, שפם...
Tracy Woods?	טרייסי וודס?
Shame. [Chuckles]	בושה. (מגחך)
- [Indistinct conversations]	- (CONVERSATIONS לא ברור)
- Hey.	- היי.
I got something.	יש לי משהו.
Hey.	היי.
Okay, I never wanted to know this much about gas chromatography or gear lubricants, but I think Mr. Reddington is onto something.	אוקיי, אני אף פעם לא רציתי לדעת את זה הרבה על גז כרומטוגרפיה או חומרי סיכה ציוד, אבל אני חושב שמר רדינגטון הוא עלה על משהו.
Look at this.	תראה את זה.
We pulled the lab reports from the NTSB, and the chopper's engine tested positive for two distinct compounds.	משכנו המעבדה דיווחים מNTSB, והמנוע של המסוק נבחן חיובי לשני מתחמים נפרדים.
The first is ethephon, which is a ripening agent for tobacco.	הראשון הוא ethephon, שהוא סוכן הבשלה לטבק.
- And how does that help us?	- ואיך זה עוזר לנו?
- Take a look.	- תסתכל.
Tobacco production's way down in this area.	דרך של ייצור טבק למטה בתחום זה.
In fact, since 1998, the federal government is actually paying farmers not to grow it.	למעשה, מאז 1998, הממשל הפדרלי הואלמעשהמשלם חקלאים לא לגדל אותו
Okay, but there's still plenty of tobacco farms.	בסדר, אבל עדיין יש שפע של חוות טבק.
I agree, which brings us to chemical compound number two.	אני מסכים, מה שמביא אותנו למספר תרכובת הכימי שתיים.
This one is used to grow sweet corn.	אחד זה משמש לגדל תירס מתוק.
So we cross-reference the two?	אז להצליב שתיים?
Exactly.	בדיוק.
We are looking for a pesticide manufacturer who used to supply tobacco growers but made the transition to corn.	אנחנו מחפשים ליצרנית חומרי הדברה שנהג לספק מגדלי טבק אבל עשה את המעבר לתירס.
And how many of those are there?	וכמה מהם נמצאים שם?
[Breathes deeply] 17. Wait.	(נושמת עמוקה) 17 חכה.
Of those, 11 are outside of the fuel range of this chopper.	מתוכם, 11 נמצאים מחוץ לדלק טווח של המסוק הזה.
Uh, of the other six, uh, only one has a structure large enough to get that stolen helicopter out of view and under construction.	אה, משש האחרים, אה, רק אחד יש מבנה גדול מספיק כדי לקבל את המסוק שנגנב מתוך נוף ובבנייה.
Halifax Agro-Chem.	הליפקס Agro-Chem.
If I had to bet, I'd say that's their staging site.	אם הייתי צריך להמר, הייתי אומר שהוא אתר האחסון הזמני שלהם.
Preston:	פרסטון:
It's around the corner, half a block up.	זה מעבר לפינה, חצי בלוק למעלה.
I make seven exterior cameras, and those are the ones they want us to see.	אני עושה שבע מצלמות חיצוניים, ואלה הם אלה שהם רוצים לראות אותנו.
And it's on the list of drop sites I gave you?	וזה על רשימת אתרי טיפה שנתתי לך?
Yes.	כן.
How long has Mr. Keen been inside?	כמה זמן יש מר קין היית בפנים?
I tailed him here four hours ago.	עקבתי אחריו כאן לפני ארבע שעות.
Lovely.	יפה.
Thank you, Preston.	תודה לך, פרסטון.
- You want me to call Sabusawa?	- אתה רוצה שאני אתקשר Sabusawa?
- That would be ideal, but he's working an extraction in Ecuador.	- זה יהיה אידיאלי, אבל הוא עובד חילוץ באקוודור.
Then how do you plan on getting keen out of that concrete box?	אז איך אתה מתכנן על מקבל להוט מתוך שתיבת הבטון?
[Chuckles] [Sighs]	(מגחך) (נאנח)
[Cellphone vibrating]	(רטט הסלולר)
- We have a lead on Xiaoping Li.	- יש לנו את יתרון שביאופינג לי.
- Red:	- אדום:
Excellent.	מצוין.
- Tell me. - We think she's being held at Halifax Agro-Chem in Falls Church.	- אנחנו חושבים שהיא מוחזקת בהליפקס Agro-Chem בפולס צ'רץ'.
We're assembling a team.	אנחנו הרכבת צוות.
Lizzy, about Tom... I don't want to talk about Tom with you.	יזי, על טום... אני לא רוצה לדבר על טום איתך.
You have your opinion on how to proceed, and I have mine.	יש לך דעתך על איך להמשיך, ויש לי שלי.
Just don't bother yourself.	רק אל תטריד את עצמך.
I'll deal with Tom.	אני אתמודד עם טום.
Lizzy, I assure you that will yield no answers and little satisfaction.	ליזי, אני מבטיח לך שלא יניבו תשובות וסיפוק קטן.
Well, I'll find out, won't I?	ובכן, אני אגלה, אני לא?
I wish I could talk you out of this.	הלוואי שהייתי יכול לדבר אותך מזה.
You can't.	אתה לא יכול.
Well, good luck with Xiaoping... [Cellphone beeps]	ובכן, מזל טוב עם יאופינג... (הסלולר צפצופים)
[Sighs] [Chuckles] [Lid thunks, lock rattles]	(דלתות נטרקות) (נאנח)
[Doors slam]	(מגחך)
Good afternoon, gentlemen.	(THUNKS מכסה, LOCK רעשנים) = = צהריים טובים, רבותיי.
I'm Raymond Reddington.	אני ריימונד רדינגטון.
Hey.	היי.
Look at this.	תראה את זה.
[Police radio chatter] What are we looking at?	(משטרת רדיו מציג) מה אנחנו מסתכלים?
I have no idea.	אין לי מושג.
Hey!	היי!
Get out of here!	צא מכאן!
Go!	Go!
[Beeping] [Explosion, car alarm blaring]	(צפצוף) (פיצוץ, בקולי קולות אזעקה של מכונת )
Tom:	TOM:
What the hell was that?	מה לעזאזל זה היה?
[Blaring continues] [Gunfire]	(רועמת ממשיך) (יריות)
Out!	החוצה!
Out! Move!	החוצה!
Move!	זוז! זוז!
Move!	זוז!
Fall back.	ליפול בחזרה.
Asset en route.	נכס בדרך.
We're moving to the cars.	אנו נעים למכוניות.
[Tires squeal]	(חריקת צמיגים)
[Tires screech, gunfire]	(חריקת גלגלים, ירי)
[Horn honks] [Tires squealing]	(הורן צופר) (צווחות גלגלים)
[Engine revving]	(מנוע מכונית)
[Gunshots]	(יריות)
[Tires screech]	(חריקת גלגלים)
Red:	אדום:
I mean, it looks like some sort of serial number.	אני מתכוון, זה נראה כמו איזה מספר סידורי.
Or an atomic number...	או מספר אטומי...
Something from a periodic table.	משהו מטבלה מחזורית.
Why do you think that?	למה אתה חושב כך?
Because the only word I know that contains the letters "v-g" together is avgolemono.	מכיוון שהמילה היחידה שאני מכיר המכילה את אותיות "VG" יחד הוא avgolemono.
I don't know what that is.	אני לא יודע מה זה.
It's a soup.	זה מרק.
Chicken stock, egg yolks, and lemon juice.	ציר העוף, חלמונים, ומיץ לימון.
What?	מה?
I cook.	אני מבשל.
The point is, maybe Xiaoping Li left us a message.	הנקודה היא, אולי שיאופינג לי השאיר לנו הודעה.
I'll run the letter combination against the DMV registry	אני ארוץ שילוב מכתב נגד רישום משרד הרישוי
- and see if we can get a hit.	- ולראות אם אנחנו יכולים להגיע ללהיט.
- Any luck?	- צלחת?
- I can't get ahold of Reddington.	- אני לא יכול לתפוס את רדינגטון.
- You told him the location where the brothers were holding Xiaoping Li, right?	- אתה סיפרת לו את המיקום שבו האחים החזיקו יאופינג לי, נכון?
- Mm-hmm.	- MM-הממ.
- Don't you find it a hell of a coincidence that we show up there, they're gone, and now we can't get ahold of Reddington?	- אתה לא מוצא את זה גיהינום של צירוף מקרים, כי אנו מציגים שם למעלה, הם נעלמו, ועכשיו אנחנו לא יכולים לקבל ישתלט על רדינגטון?
- We've been played.	- אנחנו כבר שיחקנו.
- No. Red put us on to the Pavlovich brothers because he knew it would lead him straight to Xiaoping Li.	- מס האדום הכניס אותנו ל האחים פבלוביץ' כי הוא ידע זה יוביל אותו ישר ליאופינג לי.
That woman's worth millions.	שווה מיליון של האישה הזאת.
Where are you going?	לאן אתה הולך?
I'm going to find Reddington, get some answers.	אני הולך למצוא רדינגטון, לקבל כמה תשובות.
Reddington, I need you to call me, please.	רדינגטון, אני צריך אותך להתקשר אליי, בבקשה.
I need some help with the case.	אני צריך קצת עזרה עם המקרה.
Fingers:	אצבעות:
A gift from Reddington.	מתנה מרדינגטון.
Enjoy.	תהנו.
[Door opens]	(דלת נפתחת)
[Door closes]	(דלת נסגר)
Liz:	ליז:
Two years wasted.	שנתיים מבוזבזות.
Two years we spent.	שנתיים בילינו.
On what?	על מה?
Do you care at all what you've done to me... What you've done to my life?	האם אכפת לך בכל מה שעשית לי... מה שעשית לחיים שלי?
What has it done to you?	מה זה עשה לך?
Who could do such a thing?	מי יכול לעשות דבר כזה?
Finding you, stopping you...	מציאת לך, מפריע לך...
You'd think I'd be happy you're gonna spend the rest of your life in prison.	היית חושב שאני יהיה מאושר אתה הולך לבלות את שארית חייך בכלא.
You'd think I'd get some satisfaction out of that, but I don't because nothing... No sentence, no punishment, no revenge, could ever come close to making up for what you've done.	אפשר היה לחשוב שאני אקבל סיפוק מסוים מכך, אבלאנילא ,כי שוםדבר ... לא משפט, לא עונש, אין נקמה,
- I was doing my job.	- אני עושה את העבודה שלי.
- Your job?	- התפקיד שלך?
That was our life!	זה היה בחיים שלנו!
We were going to have a baby to... You begged me to have a baby!	היינו הולכים לי תינוק... אתה התחנן ללדת אותי!
- I was doing my job.	- אני עושה את העבודה שלי.
- Stop talking about your job!	- תפסיק לדבר על העבודה שלך!
You, this...	,...
Everything was a lie!	כל מה שזה היה שקר!
My life was a lie!	החיים שלי היה שקר!
Every feeling, every memory... Say something to your wife, who's dying in front of you.	כל תחושה, כל זיכרון... תגיד משהו לאשתך, שגוססת מולך.
Say something.	תגיד משהו.
It was the shoes.	זה היה הנעליים.
What does that mean?	מה זה אומר?
That's when I knew.	כלומר, כאשר ידעתי.
It was those brown leather shoes.	זה היה נעלי עור חומות אלה .
It was our third or maybe fourth date.	זה היה התאריך השלישי או אולי הרביעי שלנו.
You'd come over to my place on Halstead, and we ordered, uh...	היית לבוא למקום שלי בהלסטד, והזמנו, אה...
Takeout and rented a movie that we never finished because we ended up... [Chuckles]	Takeout ושכרתי סרט שאנחנו אף פעם לא סיימנו כי בסופו שלנו... ( מגחך)
And you had to get up early for work.	ואתה הייתי צריך לקום מוקדם לעבודה.
And by the time I got up, you were gone.	ועד שיש לי , אתה נעלם.
I remember standing in the closet, half-dressed, reaching for my shoes when I saw that you had drawn this little heart [Scoffs lightly]	אני זוכר שעמדתי בארון, חצי לבושה, להגיע לנעליים שלי, כאשר ראיתי שאתה צייר
In the dust on my shoe.	הלב הקטן הזה (מגחך בקלילות) באבק על הנעל שלי .
You remember that?	אתה זוכר את זה?
It was the sweetest thing.	זה היה הדבר הכי מתוק.
And ever since that moment, I just felt... Sorry for you... Because I knew...	ומאז אותו הרגע, אני פשוט הרגשתי... מצטער בשבילך... כי ידעתי... ידעתי שיש לי אותך.
Part of me didn't want it to work... But it did.	החלק ממני לא רוצה שזה יעבוד... אבל זה לא.
[Sighs]	(נאנח)
Archimedes.	ארכימדס.
Archimedes!	ארכימדס!
- Meera:	- מירה:
I beg your pardon?	אני מבקש את סליחתך?
- Archimedes' formula.	- ארכימדס " נוסחה.
You know, uh, the... the naked guy who shouted "Eureka."	אתה יודע, אה,... עירום הבחור שצעק ". יוריקה"
Why would she write down a mathematical formula?	למה שהיא תכתוב את נוסחה מתמטית?
Ressler:	רסלר:
Maybe it's some kind of a code or a language they don't understand.	אולי זה איזשהו קוד או שפת שהם לא מבינים.
Archimedes' principle indicates that the upward buoyant force which is exerted on a body immersed in fluid,	ארכימדס " העיקרון מציין שהכח קליל כלפי מעלה שמופעל על גוף שקוע בנוזל,
- whether fully...	- בין אם באופן מלא...
- Aram.	- ארם.
Um, water displacement.	אום, תזוזה במים.
Boats displace water.	סירות לעקור מים.
She's trying to tell us how they're getting her out of the country.	היא מנסה לספר לנו איך הם מקבל אותה אל מחוץ למדינה.
Contact the coast guard.	צור משמר החופים.
Get photos of the brothers and Xiaoping Li to every port authority on the eastern seaboard.	קבל תמונות של האחים ויאופינג Li לכל רשות נמל בחוף המזרחי.
[Cellphone vibrating]	(רטט הסלולר)
What are you gonna tell him?	מה אתה הולך להגיד לו?
Hey.	היי.
What's going on?	מה קורה פה?
Where are we on Xiaoping Li?	איפה אנחנו ביאופינג לי?
They're trying to ship her out of the country.	הם מנסים לשלוח אל מחוץ למדינה.
We're combing through the manifests now.	אנחנו סירוק באמצעות המניפסטים עכשיו.
Where are you?	איפה אתה?
Waiting on Reddington.	מחכה ברדינגטון.
He still hasn't shown.	הוא עדיין לא הוכיח.
I'm telling you, Keen.	אני אומר לך, קין.
He used us.	הוא השתמש בנו.
These guys...	החבר 'ה האלה...
The Pavlovich brothers... You remember what they did.	האחים פבלוביץ'... אתה זוכר מה שהם עשו.
You were there that day on the bridge.	אתה היית שם באותו היום על הגשר.
When we take them down, I want you to be there.	כאשר אנו לוקחים אותם, אני רוצה שתהיה שם.
I will be, just as soon as... [Mug rattling]	אני אהיה, ברגע ש... (שקשוק MUG)
I'm gonna have to call you back.	אני אצטרך להתקשר אליך בחזרה.
Nice try.	ניסיון יפה.
I was thirsty.	הייתי צמא.
[Cellphone beeps] [Cellphone rings] Yes?	(הסלולר צפצופים) (טבעות הסלולר) כן?
- Liz:	- ליז:
Where is she?	איפה הוא?
- Who?	- מי?
Xiaoping Li.	יאופינג לי.
You took her.	לקח לך אותה.
You used the FBI and the Pavlovich brothers to get to Tom and what, get Xiaoping?	השתמשת ה-FBI ואחי פבלוביץ' כדי להגיע לטום ומה, תקבל יאופינג?
Make some bigger deal?	לעשות קצת עסקה גדולה ?
Trade on her secrets?	מסחר בסודותיה?
I have no use for germ warfare.	אין לי שימוש ללוחמה ביולוגית.
And as for using the FBI?	ובאשר לשימוש את ה-FBI?
I wouldn't be in this relationship if there wasn't a mutual benefit.	אני לא יהיה במערכת יחסי זה אם לא היה תועלת הדדית.
- Where is she?	- איפה הוא?
- I don't know.	- אני לא יודע.
I tried to bargain for her life, but negotiations went sideways.	ניסיתי להתמקח על החיים שלה, אבל משא ומתן הלך הצידה.
It was all I could do to get Tom.	זה היה כל מה שיכולתי לעשות כדי לקבל טום.
If we don't find her...	אם אנחנו לא מוצאים אותה...
If she gets sent back to the Chinese,	אם היא מקבלת נשלחה בחזרה לסינית,
- she's gonna die.	- היא הולכת למות.
- Tell me what you know.	- תגיד לי מה אתה יודע.
We think they're putting her on a cargo ship.	אנחנו חושבים שהם לשים על ספינת מטען.
We're not sure.	אנחנו לא בטוחים.
We're looking over the manifests, timetables,	אנחנו מחפשים מעל המניפסטים, לוחות זמנים,
- and shipping routes.	- ונתיבי ספנות.
- She isn't cargo, Lizzy.	- היא אינה מטענים, ליזי.
She's contraband.	היא מוברחת.
This is a smuggling operation.	זה הברחה.
And nothing gets smuggled in or out of the chesapeake without Rolph Cisco knowing about it.	ושום דבר לא מקבל הוברח פנימה או החוצה של Chesapeake בלי רולף סיסקו לדעת על זה.
Have Donald pay him a visit.	האם דונלד לשלם לו ביקור.
[Sighs] [Cellphone beeps] What is his obsession with you?	(נאנח) (הסלולר צפצופים) מהי האובססיה שלו איתך?
You guys got, like, a, uh, daddy-daughter thing going on?	יש לכם, כמו, דבר , אה, אבא ובת קורה?
What's your plan?	מה התכנית שלך?
Is daddy coming over?	אבא חוזר מעל?
Is he gonna make me talk?	האם הוא הולך לעשות לי לדבר?
No, he's not.	לא, הוא לא.
I am.	אני
[Tires screech] [Car doors open]	(חריקת גלגלים) (דלתות מכונית פתוחה)
Rolph Cisco?	רולף סיסקו?
Tell us about the Pavlovich brothers.	ספר לנו על האחים פבלוביץ' .
Who do you work for?	מי אתה עובד?
I have nothing to say.	אין לי מה לומר.
- Liz:	- ליז:
Who do you work for?	מי אתה עובד?
- Tom:	- טום:
Liz, come on.	ליז, בחייך.
You don't have it in you.	אתה לא צריך את זה אתה.
[Bone snaps] Aah!	(BONE מצליפה) אהה!
Aah!	אהה!
[Bone snaps] God!	(BONE מצליפה) אלוהים!
Aah!	אהה!
[Conversation in serbian] [Gasps]	(שיחה בסרבית) (נשימות)
[Metal clinking] [Panting]	(שקשוק METAL) (מתנשף)
[Chains rattling]	(שרשרות מקשקשת)
[Tires screech] [Sirens wailing]	(חריקת גלגלים) (סירנות מייללות)
[Indistinct shouting]	= = (צעקות לא ברורים)
[Gunfire]	(יריות)
Aah!	אהה!
Aah!	אהה!
[Gunfire stops]	(מכונות יריית תחנות)
Let me out of here!	תן לי לצאת מכאן!
Please!	בבקשה!
Get me out!	קבל אותי!
Get me out!	קבל אותי!
- [Panting]	- (מתנשף) ​​
- It's okay.	- זה בסדר.
It's okay.	זה בסדר.
Easy, easy.	לאט, לאט.
We're the good guys.	אנחנו חבר 'ה הטוב.
Here.	כאן.
Come here.	בואו לכאן.
I'm gonna put you down.	אני הולך לשים אותך.
[Sobbing]	(מתייפח)
Easy.	קל.
[Chuckles softly] You broke my thumb.	(מגחך חרש) שברת את האגודל שלי.
Yeah, I did.	כן, אני עשיתי.
If you're looking for sympathy, you might want to start with honesty.	אם אתה מחפש אהדה, ייתכן שתרצה להתחיל עם כנות.
Here's an example of honesty, Tom.	הנה דוגמא של יושר, טום.
You've been making me pancakes for two years.	אתה כבר עושה לי לביבות במשך שנתיים.
- I hate pancakes.	-  אני שונא את הלביבות.
- You want honest? Here's one.	- אתה רוצה כנה  הנה אחד.
If you're gonna handcuff somebody, don't break their thumb.	אם אתה מישהו אזיקים הולך, לא לשבור האצבע שלהם.
[Clattering] [Grunts] [Dishes clatter] [Grunts]	(שקשוק כלים) (נהמות) (נהמות)
Your handcuffs.	(שקשוק) האזיקים שלך.
One on the wrist.	אחת על פרק כף היד.
One on the banister.	אחת על המעקה. לעשות את זה.
[Handcuffs click] I am not here to hurt you, Liz.	(לחץ אזיקים) אני לא כאן כדי לפגוע בך, ליז.
- [Scoffs]	- (מלגלג)
- My job was never to hurt you.	- התפקיד שלי מעולם לא היה לפגוע בך.
I'm one of the good guys.	אני אחד מהחבר 'ה הטוב.
Reddington...	רדינגטון...
He's not who you think.	הוא לא שאתה חושב.
- I will find you.	- אני אמצא אותך.
- I can prove it.	- אני יכול להוכיח את זה.
The key in the lamp...	מפתח במנורה...
I know you found it.	אני יודע שמצאת אותו.
Take it to radford bank.	קח את זה לרדפורד בנק.
Box number 3929.	מספר התיבה 3929
He is not who you think he is.	הואלאמי שאתהחושבשהוא
Goodbye, Liz.	שלום, ליז.
[Door slams] [Intro to Josh Ritter's "Change of Time" plays]	(דלת נטרק) (מבוא ל "שינוי הזמן" ג'וש ריטר'S נצחונות)
[Exhales sharply] ♪ I had a dream last night ♪	(נושף בחדות) ♪ היה לי חלום אתמול בלילה ♪
♪ I dreamt that I was swimming ♪ ♪ and the stars up above ♪	♪ חלמתי ש אני שוחה ♪ ♪ והכוכבים למעלה ♪
- ♪ directionless and drifting ♪	- ♪ נטול כיוון ונסחף ♪
- You want me to stop him?	- ♪ אתה רוצה שאני אעצור אותו?
♪ Somewhere in the dark ♪ No, we'll just let the tail follow him.	♪ ♪ אי שם בחושך ♪ לא, אנחנו פשוט לתת הזנב אחריו.
♪ ... thunder ♪ ♪ and around me as I swam ♪	♪ רעם ♪ ♪ וסביבי בזמן ששחיתי ♪
♪ The drifters who'd gone under ♪ ♪ time, love ♪	♪ ♪ הנוודים ♪ שהלך תחת ♪ ♪ זמן, אהבת ♪
♪ time, love ♪ - ♪ time, love ♪	♪ זמן, אהבת ♪ = =
- Meera:	- ♪ זמן, אהבת ♪
Tell me about Whitefog.	- ♪ מירה: ספר לי על Whitefog. ♪
Whitefog was a black project started	Whitefog היה פרויקט שחור התחיל.
By the Chinese government five years ago.	על ידי הממשלה הסינית לפני חמש שנים.
♪ Time, love ♪ You want to tell me what's going on with Agent Keen?	♪ זמן, אהבת ♪ אתה רוצה לספר לי מה קורה ב עם סוכן קין?
- Sir?	- סר?
- Where was she today?	- איפה היא הייתה היום?
And don't tell me you don't know.	ואל תגיד לי שאתה לא יודע.
Was it Reddington?	זה היה רדינגטון?
Are there problems?	האם יש בעיות?
I think she's having troubles at home, sir.	אני חושב שהיא היא שיש צרות בבית, אדוני.
♪ I had a dream last night ♪ ♪ and rustling far below me ♪	♪ היה לי חלום אתמול בלילה ♪ ♪ ומרשרש הרבה מתחתיי ♪
♪ battered hulls and broken hardships ♪ ♪ leviathan and lonely ♪	♪ קליפות מוכות ♪ ♪ וקשיים שבורים ♪ ♪ לווייתן ובודד ♪
♪ I was thirsty, so I drank ♪ ♪ though it was salt water ♪	♪ הייתי צמאים, ולכן שתיתי ♪ ♪ למרות שזה היה מים מלוחים ♪
♪ there was something about the way ♪ ♪ it tasted so familiar ♪	♪ היה משהו ♪ ♪ על הדרך ♪ ♪ היו לו טעם כל כך מוכר ♪
♪ time, love ♪ ♪ time, love ♪	♪ זמן, אהבה ♪ ♪ זמן, אהבת ♪
♪ time, love ♪ Liz:	♪ זמן, אהבת ♪ ליז:
I lost him.	אני איבדתי אותו.
He's gone.	הוא נעלם.
No.	מס
This whole time, you've never let him out of your sight.	כל הזמן הזה, יש לך אף פעם לא פלט אותו לטווח הראייה שלך.
Your people are following him now.	האנשים שלך שעוקבים אותו עכשיו.
They are.	הם.
How is this all gonna end?	איך זה כל הסוף הולך?
This is an end.	זהסוף.
And then something new will begin.	ואז משהו חדש יתחיל.
You deserve the best in life, Lizzy.	מגיע לך הכי טוב בחיים, ליזי.
I know that sounds odd coming from a man who has brought you some of the worst,	אני יודע שזה נשמע מוזר מגיע מאדם שיש לי הביא לכם כמה מהגרוע ביותר,
but it's the reason why Tom had to work so hard to be that for you...	אבל זה הסיבה למה טום הייתי צריך לעבוד כל כך קשה כדי להיות את זה בשבילך. ..
To be kind, to be thoughtful, make you laugh, to make you love him.	כדי להיות נדיב, להיות מתחשב, לגרום לך לצחוק, כדי לגרום לך לאהוב אותו.
Because you deserve that.	בגלל שמגיע לך את זה.
And it will come.	וזה יבוא.
♪ I had a dream last night ♪ ♪ and when I opened my eyes ♪	♪ היה לי חלום אתמול בלילה ♪ ♪ וכשפקחתי את עיניי ♪
♪ your shoulder blade, your spine ♪ ♪ were shorelines in the moonlight ♪	♪ כתפך ♪ ♪ להב, עמוד השדרה שלך ♪ ♪ היית החופים ♪ ♪ באור הירח ♪
♪ new worlds for the weary ♪ ♪ new lands for the living ♪	♪ עולמות חדשים ל♪ העייפים ♪ האדמות חדשות לחיים ♪
♪ I could make it if I tried ♪ ♪ I closed my eyes, I kept on swimming ♪	♪ אני יכול לעשות את זה אם אנסה ♪ ♪ עצמתי את עיניי, ♪ ♪ המשכתי לשחות ♪
THE CHAMPION Completely broke.	"האלוף"
Meditating on the Ingratitude of humanity.	שבור לגמרי, מדיטציה על הכבוד של האנושות.
Persnickety pooch	מבט של כלב.
Spike Dugan, a fighter.	ספייק דוגאן, לוחם.
SPIKE DUGANS TRAINING QUARTERS	ספייק דוגנס מדריכי רובעים.
"The gink wants his face kalsomined."	גינק רוצה שתבדוק את הפנים שלו.
Second thoughts.	במחשבה שניה.
"Who is this weakling?"	מי החלשלוש הזה?
Bob Uppercut, the Champion.	בוב אופרקוט, האלוף.
For the Championship tonight !	לאליפות הערב!
Training for his first fight.	מתאמן לקרב הראשון שלו.
BEER	בירה
Edna, the trainer's daugher.	עדנה, בתו של המאמן.
"Five big ones if you let yourself lose."	חמשת אלפים, אם תפסיד.
The big night.	הערב הגדול.
"The Champion !"	האלוף!
"The Challenger."	הטוען לכתר.
"To the winner..." The reward. THE END subtitles by	למנצח!
THE TRAMP Featuring Charles Chaplin	הנווד Nobody תורגם וסונכרן ע"י
"He wanted my money."	הוא רצה את הכסף שלי
"As a reward you can work."	כפרס, אתה יכול לעבוד
"This is the life !"	אלו החיים
"We'll split the swag if you'll help."	אנו נתחלק בשלל אם תעזור
He plans to fool the burglars.	הוא מתכנן להטעות את הפורצים
i thunk your kindness was love but it ain't cause I seen him Good bye	חשבתי שהחסד שלך היה אהבה, אבל זה לא כיוון שראיתי אותו שלום
"No thanks."	לא, תודה
THE END subtitles by	Nobody תורגם וסונכרן ע"י
- He'll lead us to a fruitful America.	הוא הוביל אותנו לאמריקה משגשגת, ממדינת מסצ'וסטס, ג'ון פ' קנדי!
John F. Kennedy!	ג'ון פ' קנדי חי חיים שעזרו להגדיר דור שלם.
- John F. Kennedy lived a life that would help define an entire generation.	יחד נציל את הכוכב שלנו, או יחד, נישרף בלהבותיו.
- Together, we shall save our planet, or together, we shall perish in its flames.	מה היה בבחור הזה?
- What was it about that guy?	מראה, סגנון, חביבות.
- Looks, style, empathy.	הוא היה מקסים. -אינטלקטואלי ומתקדם.
- He was incredibly charming. - Intellectual and progressive.	הוא היה העתיד, הוא היה הדבר הבא.
- He was the future. He was next. - President for just over 1,000 days,	כנשיא קצת יותר מאלף ימים קנדי ניווט באירועים ובמשברים ששינו את העולם.
Kennedy navigated events and crises that changed the world.	קנדי חש את הלחץ מצד פעילי זכויות האזרח.
- Kennedy is feeling the pressure from the Civil Rights activists.	זן הייתה מדינה על סף מלחמה גרעינית.
- This was a country on nuclear war footing.	זו הטעות האחרונה שמישהו יעשה בפוליטיקה.
- This could be the last mistake that anybody makes politically.	הוא שינה אותנו בתהליך הצמיחה שלו.
- He changed us in the process of his own growth. - We choose to go to the moon in this decade and do the other things, not because they are easy but because they are hard.	אנחנו בוחרים לטוס לירח בעשור הזה ולעשות דברים נוספים לא משום שהם קלים, אלא משום שהם קשים.
- 60 years after his assassination, we are still fascinated by the triumphs and flaws of the youngest president ever elected.	‏60 שנים אחרי ההתנקשות בחייו, אנחנו עדיין מרותקים לניצחונות ולכשלים של הנשיא הצעיר ביותר שנבחר. אני מבקש מכם להצטרף אלינו לכל מה שיביא המחר, לבנות את אמריקה, לקדם את אמריקה,
- I ask you to join us in all the tomorrows yet to come, in building America, moving America, picking this country of ours up and sending it into the '60s.	לקחת את המדינה שלנו 'ולשלוח לשנות ה -60.
- The story begins on a quiet spring afternoon in May 1917 in the Boston suburb of Brookline, Massachusetts.	הסיפור מתחיל באחר צוהריים אביביים ושלווים במאי 1917, בפרבר הבוסטוני ברוקליין, מסצ'וסטס. רוז פיצג'רלד קנדי ילדה תינוק בחדר השינה הראשי של בית קנדי הצנוע.
Rose Fitzgerald Kennedy gave birth to a baby boy in the master bedroom of the modest Kennedy household.	הנשיא לעתיד, ג'ון פיצג'רלד קנדי, המכונה בפי חבריו ומשפחתו ג'ק,
The future president, John Fitzgerald Kennedy, known by his friends and family as Jack, was born on May 29th around 3:00 p.m.	נולד ב -29 במאי בשלוש אחר הצוהריים. ב
The world in 1917 was shifting.	-1917 העולם השתנה. באותה השנה אמריקה נכנסה למלחמה הגדולה, שהחלה ב
That year, America entered the Great War, which had begun in 1914.	-1914. המשמר הדומם הפגין לטובת זכויות הנשים מול הבית הלבן.
The Silent Sentinels protested in favor of women's suffrage in front of the White House. The average annual household income was $800, and the cost of a movie ticket was just seven cents.	ההכנסה השנתית הממוצעת למשק בית הייתה 800 דולר ועלות כרטיס קולנוע הייתה שבעה סנטים.
With hundreds of thousands of miles of railroad tracks,	עם מאות אלפי קילומטרים של מסילות, אמריקה, גם היצרנית הגדולה בעולם של פחם ושל ברזל,
America, also the world's largest producer of coal and iron, was at the center of a new industrial age.	הייתה בלב עידן תעשייתי חדש. תומס ג'יי קרטי, סופר קנדי נולד בתקופה שבה ארצות הברית עלתה כמעצמה עולמית.
- Kennedy is born into this time when the United States is rising as a world power. - Delivered by the family doctor,	לאחר שיולד בידי רופא המשפחה, ג'ון הוכרז בריא ונאה.
Jack was proclaimed healthy and handsome.	חייו של ג'ק הצעיר היו מאושרים ונטולי דאגות עד שחלה בשנית בגיל שנתיים.
Young Jack's life was happy and carefree until he contracted scarlet fever at age two.	בעולם ללא אנטיביוטיקה האבחנה שלו הייתה עגומה.
In a world without antibiotics, his prognosis was dim. Jack was sent to the Boston City Hospital, where his condition was so poor that he received last rites.	ג'ק נשלח לבית החולים "בוסטון סיטי", שם מצבו היה גרוע כל כך, עד שנערך לו טקס אחרון.
- The last rites are not administered trivially.	טקס אחרון לא נערך באופן טריוויאלי, דיוויד מ' קנדי, היסטוריון זוכה פרס פוליצר זה סימן למצב חמור של כמעט מוות.
That's a mark of a very, very serious near-death experience.	בתפנית בלתי צפויה בריאותו התייצבה והוא שוחרר.
- In an unexpected turn, his health stabilized and he was released.	זה היה סימן מוקדם לבעיות הבריאות הכרוניות של ג'ק.
This was an early sign of Jack's lifelong chronic health struggles.	אמו של ג'ק, רוז, גידלה את ילדיה לבדה.
Jack's mother, Rose, was effectively a single parent.	אף שסבלה את הרומנים של בעלה, ג'ו, עם נשים אחרות, מספר המיזמים העסקיים שלו, כולל בנקאות,
Though she tolerated her husband Joe's affairs with other women, his numerous business ventures, including banking, ship manufacturing during the First World War, and stock brokering, added to his frequent absences.	ייצור ספינות במלחמת העולם הראשונה ושוק מניות, כל אלה הוסיפו להיעדרויותיו התכופות.
- He was, by this time, well on his way to becoming an important businessman, and it hadn't been easy.	הוא היה בדרך להפוך לאיש עסקים חשוב. וזה לא היה קל.
From the very beginning, Joe and Rose reached an agreement that Rose was gonna raise the kids when they were little.	למן ההתחלה ג'ו ורוז הגיעו להסכם ולפיו רוז תגדל את הילדים בגיל הרך. כשהבנים יגדלו ג'ו יתערב,
As the boys got bigger, Joe would step in.	אבל ג'ו קנדי לא היה הרבה בסביבה, והיה יוצא מן הכלל אחד.
But Joe Kennedy wasn't around much, with one exception.	ג'ק לקה בשנית בגיל שנתיים,
Jack developed scarlet fever at the age of two, and before work and after work,	וכך לפני העבודה ולאחר העבודה, ג'ו נסע לבית החולים,
Joe goes to the hospital. He sits at the bedside. He watches over his son.	ישב לצד המיטה, השגיח על בנו, דיוויד נסו, סופר הוא שוחח עם הרופאים ועם האחיות.
He confers with the doctors and the nurses.	הוא נהיה ההורה היחיד.
He becomes the one and only parent. Jack Kennedy doesn't see his mother at a critical moment in his upbringing for months and months.	ג'ק קנדי לא ראה את אמו ברגע מכריע בגידולו במשך חודשים.
- When he was around, Joe showered attention, especially on the boys.	כשהוא היה בסביבה ג'ו הרעיף תשומת לב, איילין מקנמרה, היסטוריונית זוכת פרס פוליצר בעיקר על הבנים. רוז הייתה קרה, שקועה בעצמה.
Rose was cold, self-absorbed. There was something particular about the coldness from Rose that you can't.	היה משהו מסוים בקור של רוז שהיה בלתי מוסבר.
Really explain away.	רוז, כמו ג'ו, נסעה לעיתים קרובות לפרקי זמן ארוכים כשהילדים היו קטנים.
- Rose, like Joe, often went away for large stretches of time when the children were young.	ג'ק הצעיר אמר:
A young Jack was said to have remarked,	"את ממש אימא נהדרת "שנוסעת ומשאירה את הילדים לבד."
"Gee, you're a great mother to go away and leave your children all alone."	הוא אמר לחבר, כשהיה בוגר:
He told a friend while he was an adult,	לורנס ג'יי האס, סופר "אימא שלי אף פעם לא חיבקה אותי,
"My mother never hugged me, never, never."	"אף פעם."
- Instead of pitying himself, he found something else to occupy his mind.	במקום לרחם על עצמו הוא מצא משהו אחר שיעסיק אותו.
From Sinbad the Sailor to Peter Pan,	מ"סינבד המלח" עד "פיטר פן", ג'ק הוקסם מקריאה.
Jack was enthralled by reading.	העניין הספרותי שלו לא היה רק בהרפתקאות.
His literary interests did not lay solely in swashbuckling adventure. He devoured weighty historical tomes like "Lays of Ancient Rome," a popular collection of poems written in the 1840s, and "The Pilgrim's Progress,"	הוא קרא ספרי היסטוריה כבדים כמו "שכבות רומא העתיקה", אוסף פופולרי של שירים שנכתבו ב
a work of theological fiction by John Bunyan.	-1840, ו"מסעות ההלך", ספר תאולוגיה בדיונית מאת ג'ון באניין.
- There was something special about Jack.	היה משהו מיוחד בג'ק, הוא לימד את עצמו.
- When Jack was 10, his father relocated the family to New York.	כשג'ק היה בן עשר אביו העביר את המשפחה לניו יורק.
A formidable business opportunist and an investor in the stock market,	כאופורטוניסט בעסקים וכמשקיע בשוק המניות, ג'ו האב הגדיל את הונו על ידי יישום כישוריו
Joe Sr. had grown his wealth by applying his skills to various business ventures, including the film industry.	בכמה מיזמים עסקיים, כולל תעשיית הקולנוע. הוא בילה את רוב זמנו בניו יורק.
- He was spending most of his time now in New York. He was a film producer.	הוא היה מפיק סרטים, מנהל הפקה,
He was a film executive.	והצד העסקי של תעשיית הקולנוע היה מבוסס בניו יורק.
And the business side of the movie business was in New York. The Bronxville house, where Jack really grows up, is... you know, it was a mansion with a huge lawn, big driveway, lots of land for the kids to play.	בית ברונקסוויל, שם ג'ק גדל, היה אחוזה בעלת מדשאה ענקית, חניה גדולה, הרבה שטח משחק לילדים.
- The family began spending their summer and early autumn months at the beachside village of Hyannis Port, part of the Cape Cod area in Massachusetts.	המשפחה החלה לבלות את הקיץ ואת חודשי הסתיו המוקדמים בכפר הסמוך לחוף, היאנס פורט, חלק מאזור קייפ קוד במסצ'וסטס.
After renting a summer residence at 50 Marchant Avenue for several years,	אחרי ששכרו בית קיץ בשדרות מרשנט 50 במשך כמה שנים ג'ו האב קנה את הבית.
Joe Sr. purchased the home. - The family spends more time together in Hyannis Port than anywhere else.	המשפחה בילתה יותר זמן יחד בהיאנס פורט מבכל מקום אחר.
What binds them together is not their home in Bronxville but Hyannis Port.	מה שחיבר אותם לא היה הבית בברונקסוויל, אלא היאנס פורט.
- Jack was surrounded by eight siblings... Joe Jr., Rosemary, Kathleen, Eunice, Patricia,	ג'ק הוקף בשמונה אחים, ג'ו ג'וניור, רוזמרי, קת'לין, יוניס, פטרישה, רוברט, ג'ין וטד.
Robert, Jean, and Ted. Though they were raised in considerable wealth,	אף שגדלו בעושר ג'ו ורוז לימדו את ילדיהם על אודות ערך הכסף, על חשיבותו של מוסר עבודה חזק
Joe and Rose taught their children about the value of money, the importance of a strong work ethic, and the need to stay informed about world affairs, which often led to heated political discussions at the dinner table.	ועל הצורך בהתעדכנות בענייני העולם שלעיתים קרובות הובילו לדיונים פוליטיים סוערים ליד שולחן ארוחת הערב.
- Joe and Rose led conversations about current events and global events for all nine of the siblings over dinner.	ג'ו ורוז הובילו שיחות בדבר אירועים נוכחיים ועולמיים עם כל תשעת האחים בארוחת הערב, וג'ו היה מומחה בחידונים.
And Joe was like a quiz master. The parents seeded the children, particularly the boys, with this sense of history, current events, global events.	ההורים השרישו בילדים, בעיקר בבנים, עניין בהיסטוריה, באקטואליה, באירועים עולמיים,
And from that, the boys did pursue it on their own.	ולאחר מכן הבנים עקבו אחריהם בעצמם.
- Jack lived his early life in the shadow of his older brother, Joe Jr., who was the promising Kennedy child, being primed for a political future.	ג'ק חי את ראשית חייו בצל אחיו הגדול, ג'ו ג'וניור, שהיה בן קנדי המבטיח בעל צפי לעתיד פוליטי. ג'ו ג'וניור הצליח בבית הספר, אבל ציוניו של ג'ק היו די עלובים.
Joe Jr. was successful in school, but Jack's grades were comparatively poor.	ג'ק היה חכמולוג בילדותו.
- Jack was a smart aleck as a kid.	היו לו חברים.
He had friends. Every smart aleck, every jokester has friends. But he didn't try hard the way Joe did.	לכל חכמולוג, לכל בדרן היו חברים, אבל הוא לא התאמץ כמו ג'ו.
Joe was the model kid. Joe Kennedy put his faith in the future of the Kennedy dynasty, in his oldest son, Joe Jr.	ג'ו קנדי תלה את תקוות עתיד שושלת קנדי בבנו הבכור, ג'ו ג'וניור.
- Joe Sr. Seriously believed he would become the first Irish Catholic president of the United States.	ג'ו האב האמין שהוא יהפוך לנשיא האירי הקתולי הראשון של ארצות הברית. ג'ק היה בשוליים.
- Coming up on future episodes of "Kennedy"...	בפרקים הבאים של "קנדי"... ג'ון פיצג'רלד קנדי היה דמות ייחודית
- John Fitzgerald Kennedy is a unique character in U.S. and world history.	בתולדות ארצות הברית והעולם. הוא סיכן את חייו.
- He had risked his life. He'd climb one rung of the ladder, and then he'd start looking to the next one.	הוא טיפס שלב אחד בסולם והחל לחפש את השלב הבא, אבל הוא היה מוותר על כל הצלחתו הפוליטית
But he would have given up all of his political success to be pain-free.	כדי לא לסבול מכאבים. היה סיכוי שהוא ימות.
- There was a chance that he would die. Was he going to pity himself, or was he going to overcome it?	האם הוא ירחם על עצמו או יתגבר על זה?
- And we stand today on the edge of a new frontier.	ואנחנו ניצבים היום על סף חזית חדשה. כשהוא נכנס לחדר הסגלגל היה לו הרבה מה ללמוד.
- When he walked into the Oval Office, he had a lot to learn. - You have Kennedy trying to manage the Cold War, but also adhere to the real dilemma that African Americans are facing.	קנדי ניסה לנהל את המלחמה הקרה אך גם להיצמד לדילמה האמיתית שהאפריקנים אמריקנים התמודדו עמה.
- He guided the country through the most dangerous period of its existence.	הוא הנהיג את המדינה בתקופה המסוכנת ביותר לקיומה. הרעיון שניכנס למלחמה גרעינית היה מוחשי מאוד.
- The idea we could get into a nuclear war was very real.	שם קנדי היה המנהיג.
That's where Kennedy is the leader. - And so, my fellow Americans, ask not what your country can do for you, ask what you can do for your country.	חבריי האמריקנים, אל תשאלו מה המדינה יכולה לעשות בשבילכם, תשאלו מה אתם יכולים לעשות בשביל המדינה שלכם.
- Jack's playful personality and rebellious energy was at odds with his solemn and polished older brother, Joe Jr., molded by Joe Sr. In his own image.	האישיות השובבה והאנרגיה המרדנית של ג'ק היו ניגוד לאחיו הבכור והמלוטש, ג'ו ג'וניור, שעוצב על ידי ג'ו האב בדמותו.
Though Jack looked up to his older brother, the two were competitive, engaging in heated fights on the living room floor.	אף שג'ק העריץ את אחיו הגדול השניים היו תחרותיים וניהלו ריבים סוערים בסלון.
- Jack adored his older brother,	ג'ק העריץ את אחיו הגדול, ג'ו, ועקב אחריו לכל מקום.
Joe, followed him around.	השניים שיחקו יחד כל הזמן, אף שג'ו היה בריון.
The two of them played together all the time, though Joe was a bully. Jack brought a lot of the physical abuse on himself.	ג'ק הביא על עצמו הרבה מההתעללות הגופנית,
He couldn't stop teasing.	הוא לא הצליח להפסיק להציק. הוא התחיל ריבים שידע שיפסיד בהם.
He started fights that he knew he was gonna lose.	בשל משקל נמוך ושבריריות ג'ק כמעט תמיד הובס בריבי האחים,
- Underweight and frail, Jack was almost always pinned and defeated in these brotherly brawls, but he always got back up and tried again.	אבל הוא תמיד קם וניסה שוב.
In one of these competitive episodes,	באחת התחרויות ג'ו ג'וניור הציע שהוא וג'ק יתחרו על אופניים סביב ברוקליין.
Joe Jr. suggested that he and Jack race their bicycles around Brookline. The frenzied race landed Jack in the hospital with 28 stitches.	המרוץ הביא את ג'ק לבית החולים ולמצב של 28 תפרים.
- John Kennedy becomes a teenager, more or less, at the onset of the Great Depression in the early 1930s.	ג'ון קנדי היה למתבגר, פחות או יותר עם תחילת המיתון הגדול 'בתחילת שנות ה -30. זה היה אסון בלתי יתואר.
It was just an unimaginable calamity. That kind of suffering and trial by unemployment didn't touch the Kennedy family at all.	הסבל הזה מהאבטלה לא נגע כלל במשפחת קנדי.
- They were completely shielded from the Great Depression.	הם היו מוגנים לגמרי מהמיתון הגדול. הם ידעו שזה קורה,
They knew that it was happening.	אבל אולי הגאונות האמיתית של ג'ו קנדי הייתה לחשוף את ילדיו לעולם, כדי שהם יבינו
But maybe Joe Kennedy's real genius was exposing his sons to the world so that they would understand that the world was larger than the closeted life they all lived.	שהעולם גדול יותר מהחיים המוגנים שלהם.
- In September 1930, Jack began his eighth-grade year at the Canterbury School in New Milford, Connecticut.	'בספטמבר 1930 ג'ק החל כיתה ח בבית הספר "קנטרברי" בניו מילפורד, קונטיקט.
Jack loved sports, playing both baseball and football in spite of his abnormally low weight and constant health issues.	ג'ק אהב ספורט ושיחק בייסבול ופוטבול למרות משקלו הנמוך ובעיותיו הבריאותיות.
Jack often wrote to his parents about everyday life at school, including the difficulty of his studies, his frustration with the school's strict religious practices, and the freezing weather.	לעיתים קרובות ג'ק כתב להוריו על חיי היום יום בבית הספר, לרבות הקושי בלימודיו, התסכול שלו מהנהלים הדתיים הנוקשים של בית הספר ומזג האוויר הקפוא.
In April 1931, when he was almost 14 years old,	באפריל 1931, כשהיה כמעט בן 14, ג'ק סבל מכאב בטן שהוביל לניתוח תוספתן,
Jack suffered abdominal pains that resulted in an appendectomy... the first of many surgeries in his life.	הראשון מניתוחים רבים בחייו.
After this operation, he withdrew from Canterbury and returned home to Hyannis Port.	אחרי הניתוח הוא נשר מ"קנטרברי" וחזר הביתה להיאנס פורט.
Having had the summer to recover, Jack transferred to the Choate School in September 1931, a private boarding school in Wallingford, Connecticut.	אחרי שהתאושש בקיץ, ג'ק עבר לבית הספר "צ'וט" בספטמבר 1931, פנימייה פרטית בוולינגפורד, קונטיקט.
Joe Jr. was already a student there and showed Jack the ropes.	ג'ו ג'וניור היה תלמיד שם ועזר לג'ק להתרגל למקום.
- Its hallmark, from George St. John, the headmaster, was to make sure that every boy got attention and got the kind of education that he needed.	סימן ההיכר שלו, לפי ג'ורג' סנט ג'ון, המנהל, היה לוודא שכל ילד קיבל את תשומת הלב ואת החינוך הדרושים.
As a new third-former, as they were known, the ninth-graders, he was nervous.	כ"חמשוש" טרי, כפי שתלמידי ט' כונו, הוא חשש.
Fortunately, he did have an older brother to sort of steer him and give him the ropes.	ג'ודי דונלד, ארכיונאית לשעבר ב"צ'וט" למזלו, היה לו אח גדול כדי להדריך אותו, אבל הוא היה לבד.
But he was pretty much on his own, but I think that was part of the family tradition, too... to make your own way.	גם זה היה חלק מהמסורת המשפחתית, לסלול דרך משלך. הוא הוכנס למעונות, זו הרשת הראשונה.
Put into a dormitory... so that's your first network. Then, you're in classes...	אחר כך, אתה בשיעורים, זו רשת נוספת.
that's another network.	ספורט, זו רשת נוספת.
Sports... that's another network. You sort of find your way with the activities that you're involved in.	אתה מוצא את דרכך דרך הפעילויות שאתה עוסק בהן.
- Jack did well in classes he enjoyed, like math and politics, but performed poorly in subjects that didn't interest him, such as Latin.	ג'ק הצליח בשיעורים שחיבב, כמו מתמטיקה ופוליטיקה, אבל כשל בשיעורים שלא עניינו אותו, כמו לטינית.
Where he truly excelled was American history, a subject he found fascinating.	ההצטיינות שלו הייתה בהיסטוריה אמריקנית, נושא שריתק אותו.
- Kennedy loved history.	קנדי אהב היסטוריה, הוא הכיר אותה היטב
He knew it very well, and I think it gave him this grasp of how things work.	ואני חושב שזה נתן לו מושג איך דברים פועלים.
His knowledge of history informed him that being a great orator was important.	הידע שלו בהיסטוריה הוכיח לו שהיה חשוב להיות נואם טוב, איך כוח פועל,
How does power work?	קונאן אובריאן, חבר ועד קרן קנדי איך מבחינה היסטורית בעלות הברית שלנו התנהלו.
- Despite his untroubled, relaxed persona,	למרות אישיותו הקלילה והרגועה האינטליגנציה החדה של ג'ק הייתה ברורה לסובביו,
Jack's sharp intelligence was noted by those around him, including the Choate headmaster	וביניהם מנהל "צ'וט", ג'ורג' סנט ג'ון.
George St. John. - I think he saw great promise in John Kennedy but was a little frustrated by his occasional nonconformist activity.	אני חושבת שהוא ראה הבטחה גדולה בג'ון קנדי, אבל היה קצת מתוסכל מכך שהוא לא הלך בתלם לעיתים.
That just angered him because he saw such great promise in him.	זה הרגיז אותו, כי הוא ראה בו הבטחה גדולה, הוא ידע שהוא ילד חכם.
He knew he was a smart boy, and he just wanted something better out of him.	הוא רצה להפיק משהו טוב יותר ממנו.
- While at Choate, Jack met someone who would become his lifelong friend, a classmate named Lem Billings.	ב"שוט", ג'ק פגש מישהו שיהפוך לחברו הוותיק, חבר לכיתה ששמו לם בילינגס.
- One of Jack Kennedy's greatest talents was making friends and keeping them... lifelong friends.	אחד הכישרונות הגדולים של ג'ק קנדי היה לרכוש חברים ולשמר אותם, חברים לכל החיים. לם בילינגס היה חבר כזה.
Lem Billings was one. - They were both working on the school yearbook.	שניהם עסקו בספר המחזור של בית הספר, דיוויד פיטס, סופר כך הם נפגשו.
That's, in fact, how they met. But sometimes they disagreed with each other. Sometimes they would fight against each other, but there's also a lot of affection as well.	לפעמים הם לא הסכימו זה עם זה, לפעמים רבו, אבל הייתה גם הרבה חיבה.
Early on, JFK is somewhat mystified by Lem's lack of interest in girls, which, even then, as a young teenager,	בשלב מוקדם, ג'יי -אף -קיי התפלא נוכח חוסר העניין של לם בבנות, שכן אפילו אז, כמתבגר צעיר, ג'יי
JFK was very active and interested in.	-קיי היה פעיל ועסוק מאוד בתחום זה.
- While Jack excelled socially at Choate, there was another part of him most did not see.	בזמן שג'ק הצטיין מבחינה חברתית ב"צ'וט", היה חלק אחר בו שהרוב לא ראו. היו המון ניגודים.
- You see all these contrasts.	איך הוא מוצג?
So what does he present as? Handsome, born to an extremely wealthy family, rich playboy. But what do we really know?	נאה, בן למשפחה עשירה מאוד, נער שעשועים עשיר, אבל מה אנחנו באמת יודעים?
What we really know is a lot of pain.	אנחנו יודעים על הרבה כאב.
- One thing after another that sent him to the infirmary or even more specialty care, when they couldn't figure out what was really going on.	שרשרת מקרים שלחה אותו למרפאה או לטיפול מומחה כשהם לא הבינו מה קורה.
- He's having fatigue, these diffuse aches and pains.	הוא סבל מעייפות, 'ד"ר טי גלן פייט, פרופ לנירוכירורגיה ואורתופדיה מכאבים שונים, הוא פיתח קוליטיס,
He developed colitis, so he could not gain weight.	כך שלא עלה במשקל.
- In February 1934, Jack's health deteriorated rapidly.	בפברואר 1934 בריאותו של ג'ק הידרדרה במהירות.
He was sent to Rochester, Minnesota for medical tests at the Mayo Clinic.	הוא נשלח לרוצ'סטר, מינסוטה, לבדיקות רפואיות במרפאת "מאיו".
Joe Sr. came to visit his ailing son.	ג'ו האב בא לבקר את בנו. רוז לא ביקרה כלל.
He was at death's door.	הוא היה על סף מוות.
In early 1934, undergoing medical tests at the Mayo Clinic, 16-year-old Jack was plagued by constant pain, surrounded by strangers, and dealing with one medical mystery after another.	בתחילת 1934, בזמן בדיקות רפואיות במרפאת "מאיו", ג'ק בן ה -16 סבל מכאב קבוע, הוא היה מוקף זרים והתמודד עם תעלומות רפואיות רבות בשרשרת.
To pass the time, he wrote rambling letters full of jokes, often sexual in nature.	כדי להעביר את הזמן הוא כתב מכתבים מלאי בדיחות, לעיתים קרובות מיניים באופיים.
In letters written to Lem Billings during his time at the hospital, Jack's buoyant personality showed no signs of waning.	במכתבים שנשלחו ללם בילינגס בזמן שהיה בבית החולים, האישיות השובבה של ג'ק לא הראתה סימני היעלמות.
- He's making jokes, and they're jokes about his imminent death, and he's saying, "Yeah, they were here today.	הוא התבדח, הם התבדחו על מותו הקרוב, והוא אמר: "כן, הם באו היום, הסתכלתי בגיליון כשהם יצאו,
"I looked at the chart when they left the room, and I think they're measuring me from my coffin."	"אני חושב שהם מודדים אותי בשביל ארון הקבורה."
Looking at some of the numbers for his blood levels and saying, "Yeah, you know, if I get any lower, I'm out."	מסתכלים במספרים בבדיקות הדם שלו ואומרים: "כן, אם זה יצנח, אבוד לי." הוא הקליל את העניין.
Kind of making light of the whole thing. That was, I think, invaluable to what he became, which was someone who understood pain.	זה היה חלק ממה שהוא הפך להיות, מישהו שהבין כאב מהו.
- It was just one of those things where he had a choice to make. Was he going to pity himself, or was he going to deal with this and overcome it?	זה היה אחד המקרים שבהם היה עליו להחליט, האם הוא ירחם על עצמו או יתמודד ויתגבר על זה?
- People who experience that kind of pain and sickness, they understand life is pain, you know?	אנשים שחוו כאב ומחלות כאלה מבינים שהחיים הם כאב. יש גם שמחה, אבל הרבה כאב.
There's joy, too, but there's also just a lot of pain.	ההומור שלו היה דרך אחת להתמודד עם זה.
His humor was one way of dealing with it. - After months in and out of different hospitals,	אחרי חודשים של כניסה ויציאה מבתי חולים שונים, ג'ק סוף סוף היה במצב יציב מספיק לחזור הביתה בקיץ 1934,
Jack was finally stable enough to return home in the summer of 1934 with orders from his doctors to follow a strict diet and reduce stress.	עם הוראה מרופאיו לדבוק בדיאטה נוקשה ולהפחית לחץ.
- Lem was so concerned about him and helped take care of him when he was ill.	לם דאג לו ועזר לטפל בו כשהיה חולה.
- Jack and Lem were especially tight-knit, following each other around at Choate and beyond.	ג'ק ולם היו קרובים במיוחד, הלכו זה אחרי זה ב"צ'וט" ומעבר.
So close, in fact, the teens decided to lose their virginity at the same Harlem brothel.	קרובים כל כך, עד שהנערים החליטו לאבד את בתוליהם באותו בית בושת בהארלם.
- They went to prostitutes, although it's not clear that Lem actually ever did anything with a prostitute.	הם הלכו לפרוצות, אף שלא ברור אם לם באמת עשה משהו עם פרוצה, איש לא יודע.
Nobody really knows.	אחרי זמן מה ג'יי
After a while, of course, JFK being as smart as he was, he realized that Lem didn't really have any interest in women.	-קיי, בחכמתו, הבין שללם אין עניין בנשים, הוא התעניין בג'ק.
He had an interest in Jack. - Lem felt more than friendship for his companion.	לם חש יותר מרגש חברי כלפי ידידו.
A Choate tradition was to use toilet paper for notes, because they could easily be flushed and destroyed.	מסורת של "צ'וט" הייתה להשתמש בנייר טואלט לפתקים, כי אפשר היה להוריד אותם באסלה ולהשמיד אותם.
- Boys who wanted to engage in sexual behavior would hint as such on toilet paper.	בנים שרצו לעסוק בפעילות מינית רמזו זאת על גבי נייר טואלט.
- Lem sent such a note to Jack, expressing his affection for the charismatic young man.	לם שלח פתק כזה לג'ק ובו הביע את חיבתו לצעיר הכובש.
Jack politely rebuffed Lem's romantic overture, but they would remain friends and confidants for the rest of Jack's life.	ג'ק דחה בנימוס את הצעתו הרומנטית של לם, אבל הם נותרו חברים ואנשי סוד לשארית חייו של ג'ק.
He had no interest in publicly exposing Lem's sexuality, something that would subject his friend to ridicule and harassment.	לא היה לו עניין לחשוף את מיניותו של לם, הדבר היה הופך את חברו למושא ללעג ולהטרדות.
His relationship with Lem was a testament to Jack's character in a time when homosexuality was far from accepted in everyday society.	הקשר שלו עם לם היה עדות לאופיו של ג'ק בתקופה שבה הומוסקסואליות הייתה רחוקה מלהיות מקובלת.
- Jack took great risks in keeping this friendship with Lem Billings, which shows the sense of loyalty that he had.	ג'ק לקח סיכונים גדולים בשימור החברות עם לם בילינגס, ובכך הוכיח את נאמנותו.
- After being called "troublemaking muckers" by Choate headmaster George St. John,	אחרי שהוגדרו כבעייתיים על ידי מנהל "צ'וט", ג'ורג' סנט ג'ון,
Jack, Lem, and two other friends established the Choate Muckers Club.	ג'ק, לם ושני חברים נוספים הקימו את מועדון "שובבי צ'וט".
Together, they began sneaking into town for milkshakes, going to dances, and arranging pranks around campus.	יחד הם החלו להתגנב לעיר לשתות מילקשייק, יצאו לרקוד וארגנו מתיחות ברחבי הקמפוס.
- Then they came up with this wild and crazy idea that they were gonna disrupt a major dance... it's called Festivities... by depositing a load of manure at the entrance to the dance.	הם העלו רעיון מטורף, שהם יתפרצו לנשף גדול, "פסטיביטיז", ויניחו ערמות צואה בכניסה לנשף.
You can imagine the boys up in their rooms, just hooting and hollering about this thing.	אתם יכולים לדמיין את הבנים בחדרים שלהם, צוחקים על העניין. זה לא יהיה נהדר?
Wouldn't it be a great thing to do? They never did it. They never did it.	הם מעולם לא עשו את זה, הם לא עשו את זה, אבל היה כיף לחשוב על כך.
But it was fun to think about. It was a testimony, again, to Jack's ability to make friends, even if in that particular case, it was because of involvement in potential hijinks.	זו שוב הייתה עדות ליכולתו של ג'ק לרכוש חברים, גם אם במקרה הזה, זה נבע ממעורבות במתיחות.
- At last, his time at Choate came to an end.	לבסוף, זמנו ב"צ'וט" הסתיים.
Jack was now 18 and filled with a new sense of independence.	ג'ק היה בן 18 ומלא תחושה חדשה של עצמאות.
- I think he was certainly ready to leave, once graduation came around.	אני חושבת שהוא היה מוכן לעזור כשסיים את לימודיו.
- Jack found his second home on the water when back in Hyannis Port during 1935 and '36.	ג'ק מצא את ביתו השני על המים 'כשחזר להיאנס פורט ב -1935 ו
Sailing from Edgartown to Martha's Vineyard, even winning the 1936 Atlantic Coast Championship, his love of the ocean was a Kennedy hallmark.	-36, הפליג מאדגרטאון למרת'ס ויניארד, אפילו ניצח באליפות החוף האטלנטי ב -1936. אהבתו לאוקיינוס הייתה סימן ההיכר של קנדי.
- I think you can't understand the Kennedys without understanding Hyannis Port.	אי אפשר להבין את משפחת קנדי בלי להבין את היאנס פורט.
It's this big, old, rambling house. There's nine children spilling out of the rooms. They're all sailing.	זה בית גדול וישן, יש תשעה ילדים בחדרים, כולם מפליגים, מתחרים זה בזה.
They're all in competition with each other. There's a tennis court. If they're not playing tennis, they're playing touch football.	יש מגרש טניס, אם הם לא משחקים טניס, הם משחקים פוטבול.
If they're not doing that, they've got a pickup baseball game going.	אם הם לא עושים את זה הם משחקים בייסבול.
And they never lacked for companionship, because they had each other.	אף פעם לא חסרה להם חברה כי היו שם יחד. הם החברים הכי טובים שלהם.
They're each other's best friends. - Kennedy felt at one with the sea.	קנדי התאחד עם הים.
He was able to get clearer mind... they call it "blue mind"... where everything comes clear to you when you're in a maritime environment.	הוא מצא שלוות נפש, קוראים לה שלווה כחולה, דאגלס ברינקלי, סופר שהכול מתבהר כשאתה בים.
And that's why so often, he would be at Cape Cod when he would make his big decisions in his life.	לכן לעיתים קרובות הוא נסע לקייפ קוד כדי לקבל את ההחלטות הגדולות בחייו.
- In the decades to come, the family compound would serve as a source of stability and calm in Jack's ever-changing world.	בעשורים הבאים, הבית המשפחתי שימש מקור ליציבות ולרוגע בעולמו המשתנה תדיר של ג'ק.
- The principal of the Choate school wrote to the Harvard deans... I assume, the admissions office... and says, "Jack has rather superior	מנהל בית הספר "צ'וט" כתב לדקן הרווארד, משרד הקבלה, דאגלס אלמנדורף, דקן "לג'ק יש יכולת שכלית מופלאה
"mental ability without the deep interest "in his studies or the mature viewpoint	"ללא עניין עמוק בלימודיו או ההשקפה הבוגרת
"that demands of him his best effort all the time.	"הדורשים ממנו את המאמץ המיטבי כל הזמן.
"He can be relied upon to do enough to pass.	"אפשר לסמוך עליו שיעשה מספיק כדי לעבור.
"We have been and are working our hardest to develop	"עבדנו כמיטב יכולתנו כדי לפתח את העניין האישי של ג'ק,
"Jack's own self-interest. "Great enough in social life, to the point "that will assure him a record in college	"מספיק בחיי החברה, כדי להבטיח לו הצלחה במכללה,
"more worthy of his natural gifts of intelligence, likableness, and popularity."	"הרבה יותר מכישוריו הטבעיים "של אינטליגנציה, חביבות ופופולריות."
- Jack entered Harvard in fall of 1936.	ג'ק נכנס להרווארד בסתיו 1936.
- It is said that his grades weren't very good when he was a student at Harvard.	נאמר שציוניו לא היו טובים כשהיה סטודנט בהרווארד.
- At Harvard in his first year, he's interested in one thing... conquering as many women as he can.	בהרווארד, בשנה הראשונה, מרטין וו סנדלר, עורך הוא התעניין בדבר אחד, כיבוש של נשים רבות ככל האפשר. הוא היה טוב בזה.
- Though the 19-year-old Jack lost the election for freshman class president, he was active socially.	אף שג'ק בן ה -19 הפסיד 'בבחירות לנשיאות מחזור שנה א, הוא היה פעיל חברתי.
He took on the task of organizing the freshman smoker, a large party held at the end of the year.	הוא קיבל על עצמו לארגן 'את "מחששת" שנה א, מסיבה גדולה בסוף השנה.
Jack supplied first-rate tobacco and arranged for appearances by two jazz orchestras, dance groups, and baseball stars.	ג'ק סיפק טבק איכותי וארגן הופעות של שתי תזמורות ג'ז, להקות ריקוד וכוכבי בייסבול.
The party impressed his fellow students.	המסיבה הרשימה את חבריו הסטודנטים.
Jack Kennedy had captured their attention.	ג'ק קנדי משך את תשומת ליבם.
- He would just grab the coolest person there and kind of go off in the corner and have a private conversation. I mean, he was not... he was not an extrovert.	הוא היה לוקח את האדם הכי מגניב לפינה ג'ון טי שואו, כתב קונגרס לשיחה פרטית.
He was really very much of an introvert.	הוא לא היה מוחצן, הוא היה מופנם מאוד.
He did not draw energy from big groups of people. He much preferred smaller conversations. You know, had lots of friends.	הוא לא משך אנרגיה מקבוצות גדולות, הוא העדיף שיחות קטנות יותר, היו לו הרבה חברים, כמה חוגי חברים.
He had various circles of friends. - It was fun.	זה היה כיפי, קליל.
It was light. I think of him as a character of literature like Long John Silver, like incredibly charming but dangerous. You know?	אני חושב עליו כדמות ספרותית כמו לונג ג'ון סילבר, מקסים אבל מסוכן, כריס מתיוז, סופר אי אפשר לעמוד בפניו.
Like irresistible. - It's a combination of looks, style, eloquence, empathy.	זה שילוב של מראה, סגנון, דיבור, חביבות.
- I think the only word you can use is,	המילה היחידה שאפשר להשתמש בה היא שלקנדי היה "שאר רוח".
Kennedy had charisma. It was natural.	ג'יליאן סורנסן, אשת כותב הנאומים של ג'ון קנדי זה היה טבעי.
And he would come into a room and he was the center of attention.	הוא נכנס לחדר והיה מרכז תשומת הלב.
- He probably elicited more humor with fewer words than anyone.	הוא עורר יותר הומור בפחות מילים.
It was a very acerbic, deadpan, sarcastic sense of humor, great sense of timing.	חוש הומור חריף, חד ועוקצני, תזמון מעולה.
- By all accounts, being around Kennedy was incandescent.	מכל בחינה, היה נפלא להיות ליד קנדי.
It was, as Winston Churchill said of Franklin Roosevelt, like opening a bottle of champagne.	זה היה כמו שווינסטון צ'רצ'יל אמר על פרנקלין רוזוולט: אנדרו כהן, סופר "כמו לפתוח בקבוק שמפניה."
- "He looked like he could be blown over with a good breath," said Jack's new football coach.	"הוא נראה כאילו שאפשר להעיף אותו בנשיפה." אמר מאמן הפוטבול של ג'ק.
Tall and lanky, the 20-year-old Jack didn't look much like an athlete, but he tried his best to stay active in athletics like football and swimming.	גבוה ורזה, ג'ק בן ה -20 לא נראה כמו אתלט, אבל הוא ניסה להישאר פעיל בענפי אתלטיקה כמו פוטבול ושחייה.
His first two years at Harvard were lackluster academically, largely due to his interest in athletics and girls.	השנתיים הראשונות שלו בהרווארד היו פושרות מבחינה אקדמית, בעיקר בשל העניין שלו באתלטיקה ובבחורות.
However, Jack began to take his education more seriously in his junior year, even making the dean's list.	אבל ג'ק החל להתייחס ללימודיו ברצינות בשנתו השלישית, אפילו הגיע לרשימת מצטייני הדקן.
- While successful people mature at different rates, he had to find his place.	אף שאנשים מצליחים מתבגרים בקצב שונה, הוא היה צריך למצוא את מקומו.
Here, he's got this older brother, Joe Jr., who is considered the shining star of the family, and Jack has trouble dealing with that.	כאן יש לו אחיו הגדול, ג'ו ג'וניור, שנחשב הכוכב של המשפחה, וג'ק התקשה להתמודד עם זה.
And it's not until later, when he's in his advanced years at Harvard, that he gets quite serious.	רק בשלב מאוחר יותר, בהמשך שנותיו בהרווארד, הוא הרצין.
- On December 9, 1937,	בתשעה בדצמבר, 1937
"The New York Times" broke the news.	"ניו יורק טיימס" בישר את החדשות.
Jack's father, Joe Kennedy, later nicknamed "Jolly Joe"	אביו של ג'ק, ג'ו קנדי, שכונה על ידי העיתונים "ג'ו העליז",
by the press, would be the new United States ambassador to Great Britain.	מונה השגריר החדש של ארצות הברית בבריטניה.
- Just arrived in England after a very pleasant trip from the United States.	הגעתי לאנגליה אחרי נסיעה נעימה מאוד מארצות הברית.
I'm looking forward, with great anticipation, taking up my duties here.	אני מצפה מאוד למלא את תפקידי כאן.
- The Great Depression is a terrible calamity for millions upon millions of Americans.	המיתון הגדול היה אסון נורא למיליוני אמריקנים.
When Franklin Roosevelt took the oath of office in March of 1933, we estimate that there were 13 million people unemployed.	כשפרנקלין רוזוולט הושבע לנשיא במארס 1933, הערכנו שהיו 13 מיליון מובטלים,
That was about 25% of the entire workforce of the United States.	‏25 אחוז מכוח העבודה בארצות הברית. ג'ו דאג.
- Joe was worried.	הוא היה שמרן, אבל הבין שלנשיא הובר לא היה מושג
He was a conservative, but he understood that Hoover did not have a clue as to how to end the depression and save capitalism and American democracy.	איך לסיים את המיתון ולהציל את הקפיטליזם ואת הדמוקרטיה האמריקנית.
And Joe Kennedy understands earlier than most that the Depression is the greatest threat to American capitalism that this nation has ever seen.	ג'ו קנדי מבין מוקדם יותר מכולם שהמיתון הוא האיום הגדול ביותר על הקפיטליזם האמריקני שהאומה הזאת ראתה.
So he, very early, went and he joined the Roosevelt bandwagon.	בשלב מוקדם, הוא הצטרף לצוות של רוזוולט.
Kennedy really enters politics for the first time.	קנדי נכנס לפוליטיקה בפעם הראשונה.
- Joe had been a very enthusiastic and a very important supporter of FDR, particularly around election time, 1932, 1936, and 1940.	ג'ו היה תומך נלהב וחשוב מאוד ברוזוולט, בעיקר בזמן הבחירות, ‏1932, 1936 ו
And Joe Kennedy was a very important Catholic at a time when the Catholic vote, as it remains today, was very important, and he would not just contribute money, but he would entice other important people like William Randolph Hearst as well as Catholics	-1940, וג'ו קנדי היה קתולי חשוב מאוד בתקופה שבה הקתולים הצביעו, זה היה חשוב מאוד, והוא לא רק תרם כסף, הוא גייס אנשים חשובים נוספים כמו ויליאם רנדולף הרסט
around the country to support FDR. So he thought that FDR owed him.	וקתולים ברחבי המדינה לתמוך ברוזוולט, הוא חשב שרוזוולט חייב לו.
- Finally, Roosevelt gets in touch with Kennedy, and he offers him the position.	לבסוף, רוזוולט יצר קשר עם קנדי והציע לו את התפקיד.
- Joe Kennedy's new role in the public sphere would push the entire Kennedy family into the center of world politics.	תפקידו החדש של ג'ו קנדי בתחום הציבורי ידחף את כל משפחת קנדי למרכז הפוליטיקה העולמית.
- By early 1938, Joe Kennedy was the new United States ambassador to Great Britain.	בתחילת 1938 ג'ו קנדי היה השגריר החדש של ארצות הברית בבריטניה.
- That would have been the most important and most prestigious ambassadorship that would have been offered, and Franklin Roosevelt gave it to Joe Kennedy.	זו הייתה השגרירות ריצ'רד ניל, חבר קונגרס הכי חשובה ויוקרתית שאפשר להציע ופרנקלין רוזוולט נתן אותה לג'ו קנדי.
- You're kind of excited.	-זה הטיול הראשון שלי לאירופה והתרגשתי מאוד, לא נרדמתי אמש. אתה מתרגש.
- Roosevelt sends Kennedy to England as a statement as much as anything else.	רוזוולט שלח את קנדי לאנגליה כהצהרה.
It's a statement to the English that I'm gonna send you an Irish Catholic.	זו הצהרה לאנגלים: "אשלח לכם אירי קתולי."
He also tells Kennedy, "Look, I need eyes "and ears over there.	הוא גם אמר לקנדי: "תראה, אני צריך עיניים ואוזניים שם.
"Europe is falling apart, and I can't trust anybody.	"אירופה מתפרקת ואני לא סומך על אף אחד.
"I need someone over there to tell me, are the British gonna be able to fight?	"אני צריך שם מישהו שיגיד לי, הבריטים יוכלו להילחם?
"Are the British gonna be able to stand up against the Nazis?"	"הבריטים יעמדו מול הנאצים?"
- Kennedy, from the beginning, doesn't simply report on what's going on in Europe.	קנדי, מההתחלה, לא סתם דיווח על המתרחש באירופה.
Kennedy is determined that he knows better than Roosevelt and everybody else.	קנדי היה בטוח שהוא יודע יותר מרוזוולט ומכולם.
- The American people do not have to go to war.	האמריקנים לא צריכים להיכנס למלחמה.
They will not go to war if they will to stay out of war.	הם לא ייכנסו למלחמה אם יהיו מוכנים להתרחק מהמלחמה.
- He opposed U.S. involvement in the war.	הוא התנגד למעורבות ארצות הברית במלחמה.
He was actually a person who might be classified today as an appeaser.	סטיבן שלזינגר, בנו של העוזר של ג'ון קנדי הוא היה מה שנקרא היום פייסן.
